Term	Category
vote	FormLw
persistent	Virtue
accident	TrnLoss
outgoing	IPadj
commander	PowTot
turtle	ANI
squirrel	ANI
austria	Nation
pelvis	BodyPt
swiftness	IndAdj
secondary	TimeSpc
fumble	IAV
stark	Quality
appraise	EnlOth
plane	TimeSpc
sign	FormLw
enterprise	WltTot
suitable	EVAL
jug	Tool
cannot	NotLw
enact	PowTot
augment	TrnGain
salutation	ComForm
acceleration	TimeSpc
adjournment	PowTot
collectivism	PowTot
ninetieth	Source
familiarity	EnlTot
libya	Nation
fundamental	SureLw
adorable	IndAdj
not	NotLw
unesco	Source
basket	Tool
lover	AffTot
chamber	PowTot
preacher	RcTot
renunciation	ComForm
silent	Quality
valiant	IndAdj
amend	PowTot
bard	SklTot
tongue	WlbTot
historic	EnlTot
vomit	NatrPro
depict	EnlTot
unhappiness	WlbTot
gabon	Nation
arise	IAV
discredit	IAV
dynasty	PowTot
torn	Source
bombard	IAV
tentative	If
magazine	EnlTot
seem	If
adamant	IndAdj
bow	PowTot
disastrous	EVAL
grade	TranLw
pillow	WlbTot
pacification	PowTot
powerless	IndAdj
slavery	POLIT
install	TrnGain
compassionate	PosAff
equalization	Source
blindness	IndAdj
assessor	WltTot
arbitrate	PowTot
since	TimeSpc
flyer	PowTot
manure	NatObj
safety	WlbTot
underdeveloped	WltTot
exploit	PowTot
symphony	FormLw
jersey	Source
rapture	Think
muscle	PowTot
reminder	FormLw
aristocratic	IndAdj
disability	WlbTot
big	DIM
preservation	Means
uncontested	Negate
dazzle	IAV
deal	FormLw
intolerable	NegAff
preeminent	IndAdj
conscience	RcTot
economic	WltTot
blower	Tool
prospective	Time@
poetry	FormLw
assume	EndsLw
pleased	PosAff
undetermined	EnlTot
atom	NatObj
ferocity	Hostile
editorial	EnlTot
hackney	IndAdj
vulture	ANI
boy	WlbTot
outstanding	SklTot
inexpensive	IndAdj
like	PosAff
multitude	Quan
aunt	AffTot
never	NotLw
instinctive	IndAdj
disorder	PowTot
crazy	EVAL
differentiate	EnlTot
advantage	MeansLw
eliminate	PowTot
sink	TranLw
defecate	Source
protector	HU
make	IAV
media	FormLw
deference	Ought
stairway	BldgPt
official	PowTot
potential	EndsLw
mirror	Tool
proctor	RcTot
fold	IAV
distinctive	EnlTot
descry	IAV
indeed	SureLw
merciful	IPadj
knowledge	EnlTot
crowd	PtLw
rare	TimeSpc
colony	PowTot
mar	NegAff
upside	PLACE
personal	RspTot
distress	WlbTot
red	COLOR
technical	ECON
atlantic	PowTot
lecture	FormLw
subjugate	IAV
beware	IAV
conjure	IAV
sprightly	IndAdj
painful	WlbTot
aesthetic	SklTot
define	EnlTot
mile	TimeSpc
guess	EnlTot
sensitive	SklTot
fed	NegAff
explicit	FormLw
defiance	PowTot
supper	Food
attribute	IAV
pack	TranLw
gasoline	Tool
income	FormLw
inseparable	IPadj
industrialism	WltTot
conformist	PowTot
deceive	EnlTot
crucial	SureLw
humanitarian	IndAdj
pitiless	IPadj
negligent	IndAdj
thumb	BodyPt
reward	PosAff
economy	WltTot
gallery	Social
alibi	ComForm
specifically	SureLw
slap	DAV
shade	DAV
homely	SklTot
acrimonious	IPadj
dad	AffTot
nuisance	Vice
willful	IndAdj
acrimony	Vice
deck	BldgPt
learn	EnlTot
horticulture	WltTot
reactionary	NegAff
alike	Know
contrary	Negate
mediator	PowTot
rotten	IndAdj
barbarous	IndAdj
civilize	EnlTot
accurateness	Ovrst
avid	IndAdj
owe	IAV
lively	WlbTot
endless	DIM
astray	Fail
untimely	IndAdj
repay	WltTot
blown	Source
horse	ANI
stipulate	TranLw
echo	DAV
gang	PowTot
decoration	Object
deprivation	TrnLoss
nuts	Intrj
numerous	Quan
indebted	SocRel
despotism	PowTot
gear	Tool
last	TimeSpc
guilty	RcTot
luncheon	Food
cocoa	Food
crown	RspTot
refine	IAV
exit	IAV
bonny	IndAdj
muffle	TrnLoss
load	MeansLw
lustrous	IndAdj
win	WltTot
assimilate	IAV
estranged	IPadj
luminous	IndAdj
further	TimeSpc
depreciate	WltTot
area	TimeSpc
click	IAV
tolerate	RcTot
deep	DIM
reconciliation	PowTot
movie	COM
breathless	Source
frugality	WltTot
viewpoint	EnlTot
survival	WlbTot
haphazard	FREQ
clever	SklTot
perceive	EnlTot
rigor	Work
regent	PowTot
right	TimeSpc
incredibility	Negate
industrious	WltTot
competency	Eval@
glamour	Quality
psychiatrist	WlbTot
protestant	RcTot
confinement	Stay
unwavering	Negate
venezuela	Nation
goddamn	NegAff
proud	RspTot
punch	IAV
attractiveness	Quality
led	Source
fluctuate	Source
polite	FormLw
distributor	WltTot
icy	Quality
glamorous	IndAdj
twenty	CARD
moth	ANI
passport	Source
pinch	DAV
irregular	Negate
scholar	EnlTot
downfall	Finish
subordination	PowTot
turquoise	COLOR
might	If
smother	IAV
villain	HU
minus	Rel
nixon	PowTot
ton	Quan
network	Means
likeliness	Causal
withstand	IAV
catastrophe	Ovrst
imperialist	PowTot
credibility	Quality
hymn	FormLw
insert	IAV
gainer	HU
swollen	Quality
cap	Tool
empower	PowTot
counteraction	PowTot
between	TimeSpc
aluminium	Source
fruitless	EVAL
vexing	IndAdj
host	RspTot
record	FormLw
strut	IAV
switch	TranLw
trim	Source
savor	SV
poland	Nation
investigation	EnlTot
usual	TimeSpc
adoption	PowTot
bore	NegAff
aloud	Quality
equip	MeansLw
structural	Source
apologize	RspTot
machinery	SklTot
hill	Land
dominion	PowTot
cabin	Social
conversation	FormLw
brought	Source
explosion	NatrPro
eighth	Rel
rogue	HU
increase	EndsLw
gardener	SklTot
play	SklTot
while	TimeSpc
misinformed	IndAdj
lesson	FormLw
convenience	WlbTot
arrogant	NegAff
outward	TimeSpc
development	EndsLw
ordeal	Eval@
significant	SureLw
paralyzed	IndAdj
negligible	Quan
surmount	TrnGain
impasse	Stay
inaccuracy	Eval@
game	SklTot
identical	Rel
than	Source
criteria	EnlTot
incalculable	Negate
politician	PowTot
minister	WlbTot
chart	IAV
cross	NegAff
spanish	Nation
french	Nation
slayer	HU
tenderness	AffTot
use	TimeSpc
rubber	WltTot
limit	TimeSpc
buffalo	ANI
previous	TimeSpc
guitar	Tool
berate	RspTot
commonplace	Quality
stone	NegAff
breed	FormLw
swear	RspTot
spell	TimeSpc
unable	SklTot
frugal	IndAdj
muddle	IAV
wither	IAV
edition	COM
predominant	PowTot
sumptuous	IndAdj
astonish	IAV
native	HU
fought	PowTot
certain	SureLw
lazily	Fail
fertile	IndAdj
escape	PowTot
storage	MeansLw
bandit	Fetch
arduous	SklTot
spill	IAV
steel	WltTot
dreary	IndAdj
insane	IndAdj
acquaintance	AffTot
rage	NegAff
applicable	Know
wish	EndsLw
hospitable	AffTot
certify	IAV
fallacy	Quality
marker	COM
reciprocal	PowTot
bereave	SV
heed	PowTot
endow	DAV
insignificant	Negate
mare	ANI
counterbalance	PowTot
begun	EndsLw
incur	TranLw
riot	PowTot
joke	FormLw
dictatorial	IPadj
urban	PowTot
expense	FormLw
wince	IAV
gift	WltTot
unhealthy	IndAdj
unanimous	PowTot
proclaim	PowTot
significance	SureLw
baptize	DAV
loose	Quality
dope	HU
demobilize	TranLw
ignorant	EnlTot
vertical	TimeSpc
illuminate	IAV
awhile	TimeSpc
eagerness	Feel
royal	RspTot
these	Source
grateful	RspTot
tower	BldgPt
impossible	EndsLw
scarcity	WltTot
regress	TranLw
washer	Tool
intuitive	EnlTot
pity	AffTot
unspecified	FormLw
vengeance	RspTot
shore	Land
granular	Quality
deserve	RcTot
justify	RcTot
assign	FormLw
herewith	Source
lawless	IndAdj
reject	NotLw
resemble	Source
twice	FREQ
occasional	TimeSpc
imagery	FormLw
outwit	IAV
passage	PowTot
readiness	Arousal
burmese	Nation
companionship	AffTot
hesitation	If
acknowledge	TranLw
held	Source
domain	Space
misinform	EnlTot
executive	HU
fume	IAV
swam	DAV
enhance	TrnGain
unhurried	IndAdj
damned	IndAdj
reconstitute	TranLw
contemporaneous	TimeSpc
unfailing	SureLw
broadcast	FormLw
oppose	PowTot
oil	WltTot
tiger	ANI
pony	ANI
entrance	Travel
mine	WltTot
president	PowTot
preoccupation	EnlTot
flow	IAV
negate	NotLw
tutelage	EnlTot
chic	IndAdj
pace	SklTot
bungle	IAV
abrupt	PowTot
offspring	AffTot
suite	Social
noon	TimeSpc
mediocre	SklTot
vie	IAV
crop	WltTot
dish	IAV
alone	SureLw
plenipotentiary	PowTot
miss	PtLw
garrison	PowTot
attack	WlbTot
remark	FormLw
restatement	EnlTot
loop	Space
won	PowTot
consider	If
tolerance	RspTot
physicist	EnlTot
hit	If
entity	Know
struck	TrnLoss
ribbon	Tool
compensate	TrnGain
baseball	Ritual
penetrate	PowTot
outer	TimeSpc
rule	FormLw
prejudicial	NegAff
bronze	COLOR
shrink	RcTot
compulsion	Means
nonsense	EnlTot
intensive	SureLw
women	PtLw
ours	Our
evening	TimeSpc
uncommon	Negate
supplement	IAV
revolt	NegAff
nature	ABS
outfit	TrnGain
benevolent	IPadj
yawn	IAV
dollar	WltTot
beer	Food
aware	EnlTot
untrustworthy	RcTot
maternity	WlbTot
shaggy	IndAdj
permissible	PowTot
platonism	EnlTot
patrol	PowTot
petitioner	PowTot
betrayal	RcTot
merry	WlbTot
warm	PosAff
uproar	ComForm
occupational	SklTot
tennis	Ritual
thick	DIM
reduction	Decreas
unceasing	Source
misunderstanding	Fail
wreck	IAV
mother	AffTot
reverent	IndAdj
idle	IAV
inflame	IAV
minutemen	PowTot
commune	Social
rome	Name
peninsula	PowTot
girl	PtLw
audience	HU
comply	PowTot
battle	PowTot
realistic	EnlTot
prominent	Virtue
plumber	SklTot
armament	PowTot
onion	Food
predominate	PowTot
amicable	AffTot
habit	Ritual
trauma	WlbTot
dogmatism	PowTot
practise	Source
precedent	PowTot
novel	SklTot
authoritative	PowTot
misunderstood	EnlTot
divorce	AffTot
herself	Female
unfettered	PowTot
convent	PowTot
meteorite	Sky
fetch	IAV
atop	TimeSpc
connecticut	Source
culprit	Causal
summarize	EnlTot
adorn	IAV
boundary	TimeSpc
taxable	WltTot
geometry	ABS
suggestive	Perceiv
resurrect	IAV
manufacturer	WltTot
unpleasant	NegAff
objective	EndsLw
evacuate	TranLw
twelfth	Source
straggle	IAV
exult	IAV
grave	NegAff
assailant	Exert
bestow	TrnGain
split	NegAff
investment	FormLw
candy	Food
attorney	PowTot
efficiency	SklTot
maritime	Source
ordinary	Quality
blackmail	IAV
enlighten	EnlTot
garnish	IAV
criticism	FormLw
illusion	EnlTot
moisture	NatrPro
disorganized	IndAdj
collaboration	FormLw
drinker	PtLw
append	DAV
covenant	ComForm
disrupt	TrnLoss
laughter	FormLw
undermine	PowTot
treachery	Hostile
sitter	WlbTot
inviolate	RcTot
marry	AffTot
stagnant	IndAdj
intercede	IAV
immoderate	SureLw
enfranchisement	Source
ya	Intrj
foremost	RspTot
gaze	IAV
provincial	PowTot
trinidad	Nation
burnt	Source
agent	PowTot
reorganize	TranLw
glitter	IAV
youth	PtLw
crime	RcTot
doldrums	Vice
flimsy	IndAdj
groom	IAV
graduate	EnlTot
world	ArenaLw
sprung	IAV
pro	Know
thoughtful	EnlTot
wool	WltTot
museum	EnlTot
ineffectual	MeansLw
comical	IndAdj
imaginable	SklTot
inspirational	IndAdj
hazardous	EndsLw
upright	POS
linguist	EnlTot
roll	FormLw
baby	WlbTot
preposterous	IndAdj
czech	Nation
korean	PowTot
leak	IAV
implausible	Negate
tennessee	Source
sharpen	TranLw
warp	IAV
paralysis	Stay
reason	FormLw
fussy	IndAdj
tyrannical	PowTot
converse	EnlTot
look	DAV
jungle	SklTot
underworld	Polit@
peak	IAV
unwillingness	Negate
round	TimeSpc
seditious	PowTot
acquit	DAV
tremendous	DIM
tyranny	PowTot
bleak	NegAff
monarchy	PowTot
carolina	Source
logical	EnlTot
spoil	TrnLoss
pocket	Tool
relationship	Rel
attainment	EndsLw
poll	COM
squarely	Strong
appetite	Arousal
mistake	SklTot
genuine	EnlTot
comedy	Ritual
wastefulness	Eval@
match	TranLw
bad	NegAff
caller	AffTot
speechless	FormLw
shaft	IAV
navigable	IndAdj
ideology	PowTot
ritual	RcTot
mistreat	RspTot
undignified	IndAdj
took	Source
laid	TrnLoss
confer	EnlTot
exhilaration	Pleasur
ingratitude	Vice
unassured	Negate
thorn	NegAff
misled	PowTot
auspicious	PosAff
distrustful	IPadj
him	MALE
copper	WltTot
repress	PowTot
brazil	Nation
strategic	EndsLw
ward	BldgPt
impair	WlbTot
dirty	RcTot
show	FormLw
resultant	Goal
renovation	Positiv
obstacle	EndsLw
its	Source
important	EndsLw
clash	IAV
box	SklTot
frequency	FREQ
citizenship	PowTot
disturbance	Vice
originality	Quality
rise	TrnGain
champ	HU
rude	IPadj
grievous	WlbTot
bribe	IAV
hurricane	Sky
bride	AffTot
undaunted	PosAff
signatory	PowTot
popular	AffTot
excitement	WlbTot
denounce	RcTot
robbery	Fetch
nationalist	PowTot
cumbersome	IndAdj
faint	WlbTot
alienation	AffTot
summer	TimeSpc
mauritius	Nation
role	HU
watch	TimeSpc
fast	DAV
inventor	SklTot
cram	IAV
chaotic	Anomie
germany	Nation
progress	EndsLw
exasperation	EMOT
good	SureLw
green	COLOR
vulnerable	PowTot
contentment	Stay
fell	TrnLoss
relate	EnlTot
affability	Virtue
pact	PowTot
enhancement	Increas
regret	RcTot
harmonize	PowTot
pill	Tool
cannery	HU
unfamiliar	IndAdj
exhaustion	IndAdj
honour	Source
addiction	Need
betterment	EndsLw
illumination	Quality
requisite	EndsLw
conciliatory	PowTot
offence	RcTot
latter	Time@
shroud	Object
barber	SklTot
swing	DAV
allow	TranLw
grandfather	AffTot
adversary	PowTot
clog	IAV
electron	NatObj
nice	PosAff
misfortune	NegAff
yellow	COLOR
reinforcement	Affil
resist	PowTot
cohesive	PowTot
drunkard	HU
woe	Pain
differential	Know
congestion	WlbTot
drawn	Source
auction	WltTot
ready	Means
repentance	Solve
withheld	NegAff
member	HU
piece	EnlTot
sweetness	Perceiv
household	WltTot
saint	RcTot
absolute	SureLw
christendom	PowTot
demoralise	Source
concert	PowTot
dreamland	Perceiv
obtain	EndsLw
commiseration	SocRel
sane	WlbTot
fig	Food
lighten	IAV
whoever	PtLw
soil	NatObj
happiness	WlbTot
litigant	PowTot
eight	CARD
belie	IAV
different	PowTot
sluggish	IndAdj
diplomatic	FormLw
continuous	Persist
if	If
hostess	RspTot
eternal	TimeSpc
inadequate	MeansLw
feudal	IndAdj
terrible	NegAff
coordination	Rel
leather	Tool
axe	Tool
can	SV
conception	EnlTot
especially	SureLw
hearer	HU
wallpaper	Tool
commit	RcTot
authenticity	Ovrst
suit	FormLw
forgive	RcTot
breadwinner	HU
labor	SklTot
powerful	PowTot
oxen	ANI
forecast	FormLw
whirl	IAV
speaker	PowTot
ceylon	Nation
interstate	Region
arsenal	PowTot
cliff	Land
advocate	TrnGain
away	TimeSpc
displeasure	NegAff
column	Space
harm	WlbTot
filthy	IndAdj
infringement	PowTot
distrust	NegAff
improbable	Negate
prerequisite	SklTot
scold	FormLw
shift	If
undoubtedly	Negate
vicinity	TimeSpc
morning	TimeSpc
sense	If
is	Source
concur	PowTot
chad	Nation
sickness	WlbTot
elate	WlbTot
fullness	Quan
acclamation	ComForm
manoeuvre	Source
chastise	IAV
smear	IAV
spectacle	RspTot
ripe	Quality
acknowledgement	ComForm
beef	Food
oklahoma	Source
pauper	WltTot
construct	SklTot
knives	Source
authorise	Source
maybe	If
bail	IAV
prevalence	Source
dairy	Social
dakota	Source
unit	Source
hare	ANI
own	EndsLw
concrete	Quality
courtly	Polit@
wagon	Vehicle
flaunt	IAV
captain	PowTot
identity	EnlTot
bandstand	SklTot
credentials	Quality
correlate	IAV
discordant	IndAdj
sociology	Doctrin
cop	PowTot
reparation	RcTot
tribal	HU
gingerly	Quality
miracle	SklTot
weakly	Quality
period	TimeSpc
brave	RcTot
collision	Exert
choose	EndsLw
individual	PtLw
wield	TranLw
ironic	Undrst
mend	TrnGain
kindness	PosAff
wrestle	IAV
humility	RspTot
lock	TranLw
beginner	SklTot
production	EndsLw
inference	Know
inspire	PosAff
westward	TimeSpc
aggressiveness	PowTot
sew	Source
shame	RspTot
humanity	AffTot
gash	NatrPro
mitigate	TranLw
auxiliary	Source
petty	IndAdj
courteous	FormLw
invincible	PowTot
yourself	You
motivation	EndsLw
perfect	EndsLw
above	TimeSpc
refrain	IAV
crucifix	RcTot
nevertheless	Know
type	FormLw
halfway	Space
tactical	Means
definitely	Intrj
lengthy	TimeSpc
monkey	ANI
prejudice	RspTot
replacement	Vary
setup	Know
childlike	Source
solemn	RcTot
destitute	IndAdj
optimism	EndsLw
courage	RspTot
deafness	Vice
creditable	RspTot
salute	IAV
enthusiasm	WlbTot
professor	EnlTot
denunciation	NegAff
abscond	IAV
pecuniary	WltTot
shown	Source
classical	Doctrin
overrun	IAV
impede	PowTot
foreign	NegAff
ingenious	IndAdj
vanquish	IAV
tease	IAV
marcher	PowTot
defile	IAV
harbor	IAV
comparatively	EnlTot
impersonal	AffTot
co	WltTot
repent	IAV
analysis	EnlTot
clout	Power
peru	Nation
mozambique	Nation
presumptuous	Vice
striven	EndsLw
screech	FormLw
withdraw	PowTot
composure	Virtue
tale	FormLw
incentive	FormLw
trial	Ritual
casual	Undrst
hers	Female
hide	EnlTot
loyalty	AffTot
japan	Nation
counselor	WlbTot
relapse	IAV
put	PowTot
bondage	PowTot
crew	PtLw
unreliable	RspTot
cure	EnlTot
falter	IAV
apprehend	DAV
mortar	Tool
receipt	WltTot
indivisible	Source
consumer	WltTot
thereafter	TimeSpc
blizzard	Sky
terror	WlbTot
vivid	Quality
culture	EnlTot
altruistic	IPadj
corporal	HU
dissolve	IAV
coin	WltTot
stringent	IndAdj
thus	Causal
homage	RspTot
poultry	WltTot
glum	IndAdj
disregard	EnlTot
mumble	DAV
asleep	NatrPro
evasion	Negativ
maturity	RspTot
grieve	WlbTot
miner	WltTot
appeasement	PowTot
redeem	IAV
earn	FormLw
shyness	Weak
tardy	IndAdj
besiege	IAV
nod	FormLw
boom	Increas
miscarriage	TrnLoss
syrup	Food
up	TimeSpc
tap	IAV
we	Our
murderer	RcTot
invader	PowTot
weed	NatrPro
winter	TIME
resourcefulness	Know
frantically	Quality
bureaucracy	PowTot
wing	BodyPt
ice	Quality
bulk	Quan
aid	MeansLw
goods	WltTot
price	FormLw
bequeath	DAV
holder	PowTot
complicate	IAV
radius	Space
cyprus	Nation
ought	RcTot
discrepant	IndAdj
cannibal	Exert
pound	WltTot
steak	Food
juror	PowTot
observance	PowTot
appall	RcTot
easter	RcTot
year	TimeSpc
shirk	IAV
meat	WlbTot
examination	EnlTot
fish	DAV
tend	If
undeniable	SureLw
law	PowTot
walker	HU
uncouth	IPadj
subscriber	EnlTot
paradise	Relig
shortage	MeansLw
gin	Food
hay	Food
private	RspTot
allot	PowTot
pile	IAV
bale	WltTot
lawn	Social
teller	WltTot
irritable	NegAff
unchecked	Negate
superstitious	IndAdj
tired	NegAff
avaricious	IPadj
international	PowTot
recoil	IAV
yet	TimeSpc
particular	SureLw
drag	DAV
derogatory	IndAdj
wind	DAV
random	Vary
strict	Ovrst
feverish	Passive
captivation	Perceiv
stuffy	Vice
ceremony	RspTot
laboratory	EnlTot
mighty	PowTot
diction	FormLw
grandmother	AffTot
consummate	EndsLw
scream	FormLw
wry	Source
payer	WltTot
runaway	Travel
dice	Tool
contact	FormLw
unsafe	IndAdj
asia	PowTot
outcast	Ovrst
waist	Source
chemistry	Doctrin
unlucky	NegAff
meantime	TimeSpc
attainable	EndsLw
apprehensive	IPadj
irresistible	IPadj
too	Quan
blink	WlbTot
opportunity	EndsLw
elegant	EVAL
proportionate	Quan
keep	TranLw
oral	BodyPt
glee	EMOT
haste	Travel
profess	EnlTot
uncertain	If
overhaul	TrnGain
live	WlbTot
adjustable	IndAdj
skin	TranLw
brand	FormLw
carrier	HU
bug	IAV
overpower	IAV
picturesque	IndAdj
condescension	SocRel
salesman	WltTot
stoicism	Relig
move	TranLw
glorify	IAV
reliance	TranLw
land	PowTot
initial	Time@
fantastic	PosAff
retrenchment	TrnLoss
comprehend	EnlTot
reunion	Travel
shadow	IAV
netherlands	Nation
clinical	EnlTot
cool	IAV
equation	EnlTot
rider	COM
search	EnlTot
boredom	Vice
cattle	WltTot
spend	TrnLoss
thrill	WlbTot
hawaii	Source
scoundrel	HU
specialization	Doctrin
conscious	EnlTot
her	Female
bank	WltTot
disagreement	FormLw
initiative	EndsLw
experiment	EnlTot
wardrobe	Tool
modesty	Quality
threshold	BldgPt
navy	PowTot
pleasurable	IndAdj
revive	TranLw
prediction	EnlTot
client	PtLw
scholarship	EnlTot
recognize	EnlTot
pledge	RcTot
constitute	IAV
nuclei	Space
crack	DAV
salvation	RcTot
worth	WltTot
theological	RcTot
biological	Doctrin
relevant	EndsLw
retaliate	IAV
fleet	PowTot
eyebrow	BodyPt
commonsense	Know
monetary	WltTot
commensurate	IPadj
agile	IndAdj
heinous	IndAdj
boatswain	SklTot
certainty	SureLw
thirteen	CARD
beloved	AffTot
incompetent	IndAdj
madame	PtLw
amnesty	Legal
bounty	WltTot
iron	WltTot
drove	DAV
subtle	EVAL
would	SV
haven	Positiv
dependable	PosAff
affirmation	Eval@
drifter	PtLw
predecessor	PowTot
proprietary	IndAdj
defendant	HU
subjugation	PowTot
oust	PowTot
signer	PtLw
drill	IAV
horrible	NegAff
singer	SklTot
diabolical	IndAdj
affinity	Virtue
swallow	DAV
israel	Nation
substitution	Negativ
curious	EnlTot
annuity	WltTot
describe	EnlTot
distant	TimeSpc
myth	FormLw
confiscate	IAV
mainland	Land
indulgence	Ovrst
reign	PowTot
scum	Vice
hater	PtLw
mislead	EnlTot
workingmen	WltTot
hardest	Source
efficacy	ABS
stray	IAV
seventeen	CARD
venerable	IndAdj
cup	Tool
ragged	Vice
fascination	Think
overnight	TimeSpc
fret	SV
sympathetic	PosAff
tree	NatObj
beaver	ANI
suppression	PowTot
surveillance	EnlTot
greatcoat	Tool
beside	TimeSpc
hammock	Tool
expensive	WltTot
devotion	AffTot
brotherhood	AffTot
performance	SklTot
educated	EnlTot
adapt	IAV
cluster	IAV
treatise	Object
abstract	EnlTot
intertwine	IAV
theme	FormLw
compliance	PowTot
rattle	TranLw
came	Source
execute	IAV
intercourse	TranLw
strife	PowTot
invade	PowTot
bone	WlbTot
instantly	TimeSpc
thereof	TimeSpc
courageous	RspTot
strengthen	PowTot
sting	IAV
given	Source
northeast	TimeSpc
coward	RspTot
lifeless	IndAdj
princess	PowTot
regulate	PowTot
exist	TimeSpc
interim	TimeSpc
loveliness	Virtue
crusade	Travel
gleam	IAV
massacre	IAV
prowess	Know
lavatory	BldgPt
steep	Quality
frame	TranLw
entanglement	Polit@
blurt	IAV
deliberation	EnlTot
rail	Tool
droop	DAV
pertinent	EVAL
traverse	IAV
squadron	PowTot
vehicle	Vehicle
groundless	EnlTot
definitive	SureLw
default	IAV
apocalypse	Perceiv
tragic	WlbTot
action	TranLw
dispense	IAV
somebody	PtLw
intricate	IndAdj
competitor	PowTot
spread	TranLw
terrify	WlbTot
steer	PowTot
experimental	EnlTot
cow	ANI
inconvenience	NegAff
establish	TranLw
person	PtLw
essay	COM
unaccustomed	IndAdj
appraisal	EnlTot
shoe	Know
vigilant	IndAdj
tranquil	Quality
relinquish	DAV
substantiate	IAV
performer	SklTot
callous	IPadj
dense	Quality
quartet	SklTot
chicago	Name
theater	Social
unimportant	Negate
acre	WltTot
amount	EndsLw
hitherto	TimeSpc
cost	MeansLw
explode	IAV
accession	Increas
sleep	WlbTot
appear	If
honorable	RspTot
bounce	DAV
loyal	AffTot
lamentable	IndAdj
tie	TranLw
confirmation	FormLw
nervousness	EMOT
vanity	Vice
treasure	WltTot
illogical	IndAdj
detestable	IndAdj
renewal	Begin
conquer	PowTot
systematically	Means
dirt	NatObj
literature	FormLw
unrestricted	Negate
immediacy	TimeSpc
evil	RcTot
lovely	SklTot
ruin	TrnLoss
unclean	IndAdj
humor	WlbTot
basement	BldgPt
guest	RspTot
unsound	NegAff
accessible	IPadj
thicken	IAV
conqueror	Travel
expect	EndsLw
alliance	PowTot
tolerant	RspTot
whine	DAV
great	SureLw
prose	FormLw
scrutiny	EnlTot
delightful	WlbTot
discrimination	RspTot
muddy	IndAdj
subtraction	Know
address	FormLw
tact	Virtue
toil	SklTot
sigh	FormLw
death	WlbTot
purpose	SureLw
unsettling	IndAdj
copy	EnlTot
peculiar	EVAL
subside	IAV
conservation	MeansLw
subject	TranLw
everyone	Ovrst
cold	FormLw
scowl	IAV
cultural	EnlTot
neutralize	IAV
uplift	IAV
mama	AffTot
lying	FormLw
moral	RcTot
jolly	IndAdj
kneel	RspTot
reaction	TranLw
recalcitrant	IndAdj
requirement	EndsLw
there	TimeSpc
disillusion	Anomie
eye	FormLw
dying	WlbTot
liberality	Source
sturdy	Quality
rapid	Time@
trillion	WltTot
mishandle	IAV
arbitration	PowTot
nephew	AffTot
bafflement	EnlTot
matter	SureLw
steady	MeansLw
sufferer	WlbTot
adherence	RcTot
overrode	PowTot
innumerable	Negate
talented	IndAdj
aggressor	PowTot
user	HU
discussion	FormLw
cranky	IndAdj
national	PowTot
leisure	Exprsv
awkwardness	Vice
anomalous	IPadj
capitulate	IAV
ultimatum	ComForm
interpretation	EnlTot
rather	SureLw
darkness	Quality
jealousy	AffTot
declare	PowTot
accumulate	TranLw
endeavor	EndsLw
associate	EnlTot
background	TimeSpc
harmless	Virtue
yankee	PtLw
benefactor	Fetch
rapt	IAV
georgia	Name
unnerve	IAV
interested	EndsLw
length	TimeSpc
influential	PowTot
bookkeeping	WltTot
entail	Source
invite	PosAff
manipulation	Perceiv
deceptive	EnlTot
upset	NegAff
oddity	Quality
ass	BodyPt
modernization	SklTot
deterrent	PowTot
attune	IndAdj
stopper	Tool
wholehearted	PosAff
intend	EndsLw
disprove	EnlTot
quarrelsome	IPadj
factory	WltTot
fulfilment	Source
cycle	TimeSpc
way	RspTot
aghast	IPadj
receptive	IPadj
nickel	NatObj
condone	RcTot
rope	TranLw
present	TimeSpc
infuriate	IAV
at	Source
beach	Land
soldier	PowTot
admiral	RspTot
mottled	Quality
transgress	IAV
undue	Negate
arab	PowTot
recline	IAV
pursue	TranLw
daytime	TimeSpc
hesitate	If
boulevard	Route
cubic	TimeSpc
worthiness	RcTot
contradictory	FormLw
allied	PowTot
decade	TimeSpc
helpful	MeansLw
corn	WltTot
conformity	PowTot
disdain	Eval@
escort	Source
inferiority	RspTot
migration	TranLw
trick	TranLw
mirth	EMOT
enlistment	PowTot
visual	Perceiv
sunken	SV
alarm	FormLw
regular	FREQ
revival	TranLw
intuition	EnlTot
defend	PowTot
flashy	IndAdj
quarrel	FormLw
medicine	SklTot
group	PowTot
brilliant	PosAff
needy	EndsLw
train	SklTot
guard	PowTot
surprise	WlbTot
warn	FormLw
breeze	Sky
devolve	PowTot
prospect	EnlTot
finish	DAV
against	NegAff
continual	Persist
seduce	WlbTot
displease	IAV
extol	IAV
patriotism	AffTot
union	Nation
volatile	IndAdj
asset	MeansLw
die	WlbTot
appearance	Perceiv
better	PosAff
said	FormLw
until	TimeSpc
schedule	TimeSpc
orphan	HU
happen	DAV
disappointment	Anomie
orange	COLOR
coax	IAV
fever	WlbTot
extraordinary	SureLw
average	RspTot
saturday	TimeSpc
vision	Perceiv
witty	IndAdj
prior	TimeSpc
mistress	AffTot
recognise	Source
mark	SureLw
oasis	PLACE
consecrate	RcTot
folk	ArenaLw
got	Source
sprinkle	IAV
reverse	IAV
stem	IAV
protective	IndAdj
defray	WltTot
flexible	Quality
block	PowTot
prosper	IAV
forwardness	PowTot
frequent	TimeSpc
sidewalk	Route
disobedience	Vice
football	Ritual
age	TimeSpc
material	SureLw
edible	IndAdj
observation	EnlTot
voyage	Travel
priceless	IndAdj
medical	WlbTot
silly	EVAL
electronics	Doctrin
somewhere	TimeSpc
stroke	IAV
gentle	PosAff
obsolete	IndAdj
consolation	PowTot
inspiration	EnlTot
freight	WltTot
climb	IAV
issuance	FormLw
thy	You
soviet	Nation
earner	WltTot
allusion	FormLw
sing	FormLw
benefit	FormLw
dogma	PowTot
cuba	PowTot
composite	Quality
vital	EndsLw
procrastinate	IAV
perfume	Quality
lucky	EndsLw
erode	DAV
short	TimeSpc
forty	CARD
disadvantage	EndsLw
frog	ANI
awake	DAV
moody	IndAdj
impossibility	EndsLw
racer	HU
whisper	FormLw
dissension	NegAff
indeterminate	IndAdj
consult	EnlTot
navigation	Source
invisible	IndAdj
tea	Food
university	EnlTot
creation	EndsLw
appropriation	FormLw
chain	IAV
sample	IAV
cleanse	DAV
wane	IAV
preparation	Vary
carefree	IndAdj
forward	TimeSpc
dryer	Tool
devious	IndAdj
mistreatment	RcTot
confirm	SureLw
opponent	PowTot
immigrant	PtLw
ring	DAV
transport	WltTot
fruition	Complet
stood	TranLw
wail	IAV
zenith	PLACE
exotic	IndAdj
gratuitous	IndAdj
fellow	AffTot
optimistic	EndsLw
cheque	WltTot
pilgrimage	RcTot
reception	Ritual
unsteady	If
wanton	NegAff
gasket	Tool
intelligence	EnlTot
entangle	IAV
nurse	SklTot
apt	Ovrst
admittance	Travel
jerk	NegAff
outrage	RcTot
burma	Nation
forget	EnlTot
vigour	Source
secretary	SklTot
disarm	IAV
squall	Sky
flagrant	IndAdj
discharge	TranLw
name	FormLw
abatement	Source
berserk	IndAdj
defeat	PowTot
catholic	RcTot
fraction	Quan
circulation	Travel
incompatible	PowTot
centre	Source
outreach	IAV
plus	Quan
onto	Space
rag	Tool
respite	Stay
guarantee	FormLw
competent	SklTot
dear	SureLw
idea	EnlTot
intrust	TranLw
diagnosis	EnlTot
concept	EnlTot
fit	WlbTot
inspect	EnlTot
scrawl	IAV
busy	Virtue
diet	WlbTot
seal	TranLw
least	SureLw
gallon	Quan
questionnaire	EnlTot
jar	TranLw
lonesome	IPadj
photographic	ComnObj
discreet	Virtue
genial	PosAff
subjective	Know
cocktail	Food
document	COM
hydrogen	NatrPro
affection	AffTot
people	ArenaLw
full	Quan
avert	If
famished	IndAdj
i	Self
stud	HU
allegation	FormLw
unleash	PowTot
minority	PowTot
brotherly	IPadj
guild	PowTot
table	EnlTot
inform	EnlTot
pea	Food
regard	EnlTot
taut	Quality
enjoyable	WlbTot
opposite	PowTot
statute	FormLw
maximum	Quan
neighbourhood	Source
distract	EnlTot
hustle	IAV
position	PowTot
discomfort	WlbTot
allotment	PowTot
mongolia	Nation
delight	WlbTot
prominence	Eval@
tank	Vehicle
forceful	PowTot
sensory	EnlTot
list	TranLw
coexistence	PowTot
twist	TranLw
what	Intrj
undo	TrnLoss
commotion	Ovrst
find	EnlTot
amenity	Object
yourselves	You
nervous	WlbTot
by	Means
opposition	PowTot
honor	RspTot
childish	RspTot
electronic	Tool
indisputable	SureLw
deficit	WltTot
lord	RspTot
photo	COM
budget	WltTot
hunger	WlbTot
obedience	Active
pout	SV
cogent	IndAdj
recede	IAV
expire	IAV
belly	BodyPt
verification	EnlTot
inexact	Negate
naughty	IndAdj
check	WltTot
concurrent	TimeSpc
beat	PowTot
consistency	Virtue
appeal	FormLw
abolition	TranLw
barrel	Tool
quite	SureLw
harness	DAV
fuel	Tool
substance	MeansLw
night	TimeSpc
phenomena	Know
fitness	NatrPro
vulnerability	PowTot
canoe	Vehicle
absorption	Increas
orleans	Name
acute	SureLw
unfinished	IAV
murder	TrnLoss
expansion	EndsLw
cake	Food
tempest	NatrPro
ore	WltTot
pervert	HU
twentieth	Source
dissemination	EnlTot
clarify	EnlTot
dissatisfy	IAV
malice	NegAff
weu	Source
aggravate	PowTot
fashion	SklTot
facial	BodyPt
irritation	NegAff
widower	AffTot
immense	Space
lifetime	TimeSpc
pomp	Ritual
assembly	PowTot
similar	Rel
scandal	RcTot
timber	WltTot
warmhearted	IndAdj
franchise	PowTot
suicidal	WlbTot
sinister	NegAff
austere	IndAdj
engine	WltTot
equipment	MeansLw
swore	RspTot
acceptance	PosAff
cameroon	Nation
estimate	FormLw
heater	Tool
disguise	Object
gate	BldgPt
texas	Name
wealthy	WltTot
possibly	If
testament	RcTot
unlikely	Negate
portable	IndAdj
imaginary	Know
obstruction	Stay
waterfront	Social
principle	RcTot
agony	NegAff
patronage	PowTot
emphasize	SureLw
persuasive	IPadj
decimal	Quan
pencil	COM
acknowledgment	RspTot
maintain	EnlTot
calcium	NatObj
strike	NegAff
pitiful	IPadj
suppose	EnlTot
shriek	DAV
delusion	EnlTot
population	WltTot
to	IAV
whatsoever	Intrj
resent	NegAff
rampant	Vice
enclose	IAV
versatility	Vary
technology	SklTot
feeble	NegAff
men	PtLw
flint	NatObj
unseen	IndAdj
eec	Source
pursuer	PtLw
sanction	FormLw
agitation	PowTot
cheapen	IAV
swift	Time@
thieves	RcTot
bathe	DAV
backwardness	WltTot
defence	PowTot
chat	Source
proposition	FormLw
seldom	TimeSpc
sizable	DIM
pointer	COM
specify	TranLw
meager	IndAdj
curtail	IAV
extension	Space
thee	You
kidney	BodyPt
compassion	PosAff
lawful	PowTot
populate	WltTot
boisterous	IndAdj
cooperate	PowTot
stubbornness	Stay
gracious	SklTot
conference	EnlTot
successive	Persist
stubborn	EVAL
worry	WlbTot
resound	IAV
arrange	TranLw
department	WltTot
promoter	PowTot
mechanism	Tool
tone	Quality
diseased	IndAdj
strove	TranLw
very	SureLw
elector	PowTot
armed	PowTot
fanatic	Need
protracted	TimeSpc
exportation	WltTot
week	TimeSpc
incline	TranLw
launch	TranLw
agriculture	WltTot
chief	PtLw
lung	WlbTot
strenuous	PowTot
delicacy	Quality
taint	IAV
assignment	PowTot
reputable	RspTot
quandary	If
exclusion	SocRel
touch	FormLw
reality	EnlTot
hectic	IndAdj
curse	FormLw
ma	AffTot
treasonous	IPadj
shortcoming	Vice
pay	TrnGain
concede	PowTot
stamp	TranLw
viewer	HU
notable	RspTot
outcry	ComForm
avenue	Route
usa	Source
stupidity	Vice
frighten	WlbTot
social	ArenaLw
humour	Source
streak	Quality
regime	PowTot
zero	CARD
teacher	EnlTot
forest	WltTot
velocity	Time@
bristle	IAV
artistic	SklTot
arabia	Nation
michigan	Source
swimmer	HU
devout	IndAdj
mission	EndsLw
safeguard	PowTot
grim	NegAff
actor	PowTot
formality	Ought
nest	AffTot
tuesday	TimeSpc
solidarity	PowTot
paid	Source
capsize	IAV
borne	TranLw
accumulation	TranLw
conclusion	TimeSpc
commemoration	Ritual
contradiction	ComForm
keen	PosAff
wisdom	EnlTot
fidget	IAV
children	WlbTot
are	SV
forgiveness	RcTot
jointly	PowTot
unexpectedly	Eval@
gay	WlbTot
anymore	TimeSpc
pool	TranLw
stretch	TimeSpc
flatness	Space
drizzle	DAV
dog	ANI
endorse	PowTot
toll	FormLw
towering	DIM
conserve	MeansLw
fiery	IndAdj
airplane	Vehicle
deservedly	Ought
hesitant	If
municipality	PowTot
rosy	IndAdj
corrosion	Decreas
drip	DAV
superstition	Perceiv
cave	PowTot
avenge	PowTot
deluge	Ovrst
plaintiff	ComForm
yield	PowTot
unlike	IndAdj
blatant	IndAdj
normal	EVAL
disagreeable	PowTot
prey	ANI
probability	ABS
steppes	Region
prudent	EnlTot
succumb	IAV
cottage	Social
rocky	Quality
eater	WlbTot
anew	FREQ
sovereignty	PowTot
behalf	Virtue
incident	Time@
ability	MeansLw
changeable	Vary
commencement	EndsLw
nag	NegAff
purple	COLOR
prevention	IAV
restriction	PowTot
ultimate	Time@
intrigue	PowTot
reinstate	IAV
unconquerable	PowTot
partook	TranLw
dialect	FormLw
magnetic	IPadj
jest	IAV
convince	FormLw
confuse	If
criterion	EnlTot
elsewhere	TimeSpc
mutton	Food
read	FormLw
aden	Nation
hurtle	IAV
cadillac	RspTot
legislator	PowTot
large	DIM
comestible	IndAdj
card	Tool
sport	PosAff
treason	RcTot
seventeenth	Source
segment	Space
helpless	MeansLw
lain	Source
border	IAV
gall	EMOT
pleasantry	ComForm
sun	Sky
acquittal	Solve
energetic	WlbTot
message	FormLw
deploy	PowTot
hug	DAV
painstaking	IndAdj
proprietor	WltTot
confederation	SocRel
unjust	RcTot
troublesome	NegAff
thirteenth	Source
album	COM
arrogance	Vice
blood	WlbTot
uprising	Hostile
competence	SklTot
tropical	Region
triumphal	IndAdj
degree	FormLw
afflict	TrnLoss
imply	IAV
pulley	Tool
treacherous	Vice
decline	TrnLoss
tin	WltTot
tingle	IAV
interact	PowTot
fourteen	CARD
goat	ANI
stagger	IAV
cruel	NegAff
occupation	SklTot
end	TimeSpc
renounce	PowTot
veteran	PowTot
numerical	Quan
embitter	NegAff
augmentation	Increas
nor	NotLw
grizzly	IndAdj
contagious	IPadj
woman	PtLw
programme	Source
military	PowTot
tranquillity	PowTot
noticeable	EnlTot
negotiator	PowTot
nowhere	Region
bay	Aquatic
handle	PowTot
skilful	Source
stick	NegAff
selective	PowTot
cylinder	Tool
parallel	POS
utterly	SureLw
tactic	Means
pioneer	EnlTot
province	PowTot
representative	PowTot
hard	If
window	Source
retirement	WltTot
despise	NegAff
formal	RspTot
snack	Food
rodent	ANI
theft	RcTot
leave	FormLw
management	WltTot
upward	Space
still	TimeSpc
vocational	SklTot
coffin	WlbTot
inject	Source
density	Quality
surface	TimeSpc
immigration	Source
necessarily	Causal
brusque	IPadj
hobble	IAV
filly	ANI
motorist	PtLw
rumple	IAV
healthful	IndAdj
ecuador	Nation
mayor	PowTot
correspondence	FormLw
qualm	Feel
post	EnlTot
abstraction	EnlTot
chest	BodyPt
reunite	IAV
unbelievable	EnlTot
reference	FormLw
unhappy	WlbTot
rivalry	SocRel
key	EnlTot
employer	WltTot
flair	Virtue
wretch	IAV
reputation	RspTot
undertaker	HU
vigorous	WlbTot
continuum	Space
erosion	Decreas
prohibition	PowTot
weakness	PowTot
feast	WlbTot
diversion	Perceiv
consensus	PowTot
neighbour	Source
stress	IAV
wooden	Quality
file	IAV
rhinoceros	ANI
improve	TrnGain
establishment	PowTot
premier	Begin
devote	AffTot
friendliness	AffTot
challenge	EndsLw
hypocrite	ComForm
slug	ANI
stalin	PowTot
gotten	Source
mode	Means
choke	DAV
greet	FormLw
pervade	Source
limitless	TimeSpc
forlorn	IndAdj
why	EnlTot
philosophy	EnlTot
closeness	Space
saga	FormLw
satisfaction	WlbTot
explanation	FormLw
hence	Causal
miller	WltTot
highway	WltTot
pond	Source
grow	TranLw
related	EnlTot
texture	Quality
sedan	Vehicle
variation	ABS
mississippi	Source
commodious	IPadj
inviolable	RcTot
parental	AffTot
proposal	FormLw
peacock	ANI
reverence	RspTot
persuasion	PowTot
geographical	Space
math	EnlTot
insurance	MeansLw
fracture	IAV
invariable	Negate
policeman	PowTot
mortality	WlbTot
radio	COM
durable	WlbTot
outlook	EndsLw
ash	NatObj
stimulate	IAV
goodbye	Intrj
commuter	PtLw
slim	DIM
trout	ANI
bosom	WlbTot
untrue	Negate
schoolroom	EnlTot
unique	SureLw
publicity	FormLw
shrewdness	Know
supremacy	PowTot
thought	Source
major	EnlTot
permit	PowTot
vocabulary	FormLw
past	TimeSpc
direct	TimeSpc
usable	MeansLw
nullify	IAV
adultery	SocRel
synthesis	Rel
cancel	DAV
neck	BodyPt
athletic	Exprsv
facilitate	MeansLw
truant	IndAdj
biblical	RcTot
sprang	IAV
flesh	WlbTot
diligent	SklTot
federation	PowTot
category	EnlTot
distinct	EnlTot
risk	EndsLw
uncertainty	EnlTot
applicant	SklTot
condensation	NatrPro
questionable	Undrst
evacuation	TranLw
resident	PtLw
dignified	IndAdj
dusk	TimeSpc
assess	EnlTot
motive	EndsLw
several	Quan
code	FormLw
line	TranLw
wench	HU
hurtful	IPadj
sentence	FormLw
congratulation	FormLw
crept	DAV
indulge	IAV
affair	AffTot
product	SklTot
assistance	PowTot
risen	Source
unfit	NegAff
barbarian	HU
growl	IAV
sleepless	IndAdj
contain	DAV
demon	Vice
air	FormLw
heard	Source
lucrative	IndAdj
it	Source
hot	NegAff
jurisdiction	PowTot
stimulus	FormLw
hurry	IAV
taxi	Vehicle
butcher	HU
withhold	NegAff
sunday	TimeSpc
pathetic	IndAdj
natural	Causal
behind	TimeSpc
ireland	Nation
supporter	PowTot
mistrust	IAV
sunder	IAV
cognizant	IndAdj
fix	TranLw
disposal	PowTot
punishment	PowTot
inferior	NegAff
indicate	EnlTot
case	If
desire	EndsLw
fringe	Space
dilemma	If
front	TimeSpc
sunlight	Sky
swung	DAV
foster	TrnGain
superfluous	IndAdj
warmth	PosAff
route	TimeSpc
plausibility	Eval@
insist	TranLw
slacks	Tool
psychological	WlbTot
scrub	TranLw
bin	Tool
tomorrow	TimeSpc
therapeutic	IndAdj
standpoint	FormLw
unsuccessful	IndAdj
sacrifice	TrnLoss
haze	Sky
permission	FormLw
class	RspTot
gas	IAV
pig	ANI
evolutionary	Source
costly	WltTot
literally	Know
ingenuity	Know
earliest	TimeSpc
plausible	Virtue
trample	IAV
eradicate	IAV
undependable	Negate
ridiculous	RspTot
switzerland	Nation
goddess	RcTot
deepen	IAV
revitalize	IAV
burst	IAV
useful	PosAff
forever	TimeSpc
innocent	RcTot
next	TimeSpc
wash	DAV
planter	SklTot
subdue	PowTot
extravagance	MeansLw
legion	PowTot
absence	Know
affix	DAV
peer	RspTot
stock	WltTot
anxiousness	WlbTot
fervor	Feel
spank	DAV
drama	Ritual
their	Source
commemorate	IAV
stance	FormLw
lend	WltTot
tenth	Source
skyline	Sky
approximately	If
compose	SklTot
creator	RcTot
civic	PowTot
oak	NatObj
melt	DAV
poetic	SklTot
sponsor	IAV
undesirable	IndAdj
affectation	Vice
straight	Space
uganda	Nation
ail	SV
assumption	EnlTot
confidence	FormLw
annihilation	Finish
upbeat	IndAdj
fine	FormLw
enchantment	EMOT
pursuant	PowTot
insensible	IndAdj
supervision	PowTot
sale	WltTot
timid	Vice
director	PowTot
outsider	HU
oppressive	IndAdj
balance	PowTot
pastor	RcTot
virtuous	RcTot
journey	IAV
bituminous	Source
fortunate	PosAff
library	EnlTot
wood	WltTot
spain	Nation
dipper	Tool
geographic	PowTot
odour	Source
selfish	RspTot
typewriter	COM
angola	Nation
blameless	IndAdj
pend	If
issue	TranLw
provisional	Time@
unattractive	SklTot
row	DAV
conscientious	Virtue
beneficiary	HU
merger	Rel
fraught	IndAdj
thud	Perceiv
one	CARD
universal	SureLw
pretension	RcTot
inherit	DAV
consist	IAV
craft	ECON
availability	Virtue
worship	RcTot
validity	EnlTot
interdependence	PowTot
governor	PowTot
orator	PowTot
association	EnlTot
eat	WlbTot
lie	FormLw
state	ArenaLw
exempt	IndAdj
imagine	IAV
ledger	WltTot
adjust	TrnGain
resplendent	IndAdj
depart	DAV
genius	SklTot
substitute	TranLw
recurrent	FREQ
became	IAV
grape	Food
marvel	IAV
compliment	IAV
sea	Aquatic
defense	PowTot
pole	Space
founder	PtLw
indignation	EMOT
plea	FormLw
remuneration	WltTot
crossroad	Route
soft	Quality
achieve	EndsLw
shelves	Tool
tumble	TranLw
season	TimeSpc
fault	SklTot
everywhere	TimeSpc
railroad	Route
giver	PtLw
canyon	Land
accelerate	EndsLw
probe	Means
cellar	BldgPt
roommate	AffTot
fury	WlbTot
accuracy	EnlTot
halt	TranLw
indecision	If
spent	Source
lot	EndsLw
elegance	Virtue
tenacious	IndAdj
handicap	MeansLw
blithe	IndAdj
evolution	Vary
pretense	Fail
disadvantageous	EndsLw
rebuff	IAV
brandish	PowTot
adopt	PowTot
though	Source
administrator	PowTot
ordinance	FormLw
brutality	Ovrst
federal	PowTot
incest	AffTot
excite	WlbTot
open	TranLw
shy	EMOT
vigor	WlbTot
shapely	Quality
disapprove	RspTot
paste	IAV
absurd	Ovrst
labourer	Source
interpose	IAV
revaluation	WltTot
erect	TranLw
act	TranLw
brief	TimeSpc
reconstruct	TranLw
territory	PowTot
institution	PowTot
commerce	WltTot
antiquated	IPadj
revenue	WltTot
veritable	IndAdj
adept	SklTot
automatic	Tool
place	TimeSpc
firmness	Quality
believer	RcTot
propriety	RspTot
outlive	DAV
sloth	ANI
secession	Travel
grumble	NegAff
outlaw	RcTot
partition	IAV
ruthlessness	Hostile
ascertain	EnlTot
peasant	RspTot
practicable	SklTot
slanderous	IPadj
undisturbed	Source
stolen	RcTot
security	WltTot
override	PowTot
mention	FormLw
operate	TranLw
valuation	EndsLw
critical	EnlTot
male	PtLw
revolution	PowTot
completeness	ABS
indefinite	If
bid	PowTot
generality	EnlTot
proof	EnlTot
democracy	PowTot
mice	ANI
remarkable	SureLw
shove	DAV
decay	DAV
here	TimeSpc
resume	TranLw
humiliation	EMOT
before	TimeSpc
quibble	IAV
unremitting	Source
restaurant	Social
concentration	EnlTot
faithfulness	Virtue
stadium	Social
moan	DAV
insult	RspTot
delay	TranLw
melody	FormLw
dawdle	IAV
senseless	IndAdj
suppress	PowTot
fade	IAV
conservatism	PowTot
visualization	Perceiv
seamen	SklTot
inexpedient	EndsLw
naive	EnlTot
zeal	AffTot
believe	EnlTot
sad	WlbTot
kindred	AffTot
process	IAV
house	WlbTot
landmark	Land
calculate	EnlTot
debtor	WltTot
vouchsafe	IAV
you	You
congressional	PowTot
leaf	NatrPro
naked	Quality
alien	HU
hurt	WlbTot
slime	Object
hatred	NegAff
rough	TimeSpc
drunken	WlbTot
discovery	EnlTot
index	COM
stalemate	Stay
irony	Undrst
wasteful	IndAdj
disposition	WlbTot
err	IAV
or	Know
nevada	Source
represent	PowTot
pandemonium	Anomie
shook	Source
cord	Tool
grower	WltTot
mediterranean	PowTot
core	Space
drunk	WlbTot
whom	PtLw
share	PowTot
gazette	EnlTot
society	ArenaLw
currency	WltTot
autumn	TimeSpc
beacon	EnlTot
survive	WlbTot
eyelid	BodyPt
poignant	IndAdj
ant	ANI
fearsome	IndAdj
junta	PowTot
rocker	Tool
morale	Think
weight	PowTot
more	Quan
limb	BodyPt
insinuate	RspTot
capable	MeansLw
posture	ArenaLw
purposeful	IndAdj
hair	IAV
wonder	If
drown	WlbTot
apologetic	IPadj
manipulate	PowTot
brittle	IndAdj
motionless	IndAdj
muscular	PowTot
compress	IAV
lioness	ANI
dessert	WlbTot
oblique	IndAdj
review	EnlTot
wartime	PowTot
collaborate	IAV
diligence	SklTot
autocratic	IPadj
surrender	PowTot
clatter	ComForm
effort	EndsLw
specific	Know
despair	Anomie
informal	RspTot
pink	COLOR
ambulance	WlbTot
knelt	RspTot
invariably	SureLw
fraternal	AffTot
godlike	IndAdj
have	RcTot
today	TimeSpc
unbroken	IndAdj
debt	WltTot
darling	AffTot
metropolis	PowTot
bright	PosAff
hate	NegAff
back	TimeSpc
marble	NatObj
domestic	PowTot
dwindle	IAV
prodigy	Know
gigantic	Quan
start	EndsLw
exceptional	SureLw
cheap	WltTot
awaken	Source
qualify	SklTot
real	SureLw
brazen	IndAdj
plastic	Tool
delude	EnlTot
implicate	RcTot
surmise	IAV
beautify	IAV
ludicrous	IndAdj
survey	EnlTot
jubilant	WlbTot
wilt	IAV
comprise	IAV
electoral	PowTot
stink	IAV
banishment	SocRel
civility	Virtue
chapter	FormLw
din	ComForm
creative	EndsLw
dwell	DAV
hopeful	EndsLw
shatter	TranLw
suave	IPadj
uninformed	IndAdj
ever	TimeSpc
impotent	MeansLw
betroth	IAV
avoid	If
rhythm	TimeSpc
formidable	Vice
stair	BldgPt
sent	DAV
duration	TimeSpc
allies	HU
error	SklTot
irregularity	Negate
psychologist	EnlTot
non	NotLw
pressure	PowTot
portrait	COM
turmoil	Vice
northern	TimeSpc
brain	EnlTot
satisfy	TrnGain
heritage	AffTot
ambiguous	If
hamper	TrnLoss
profiteer	WltTot
economist	WltTot
push	PowTot
discuss	EnlTot
planner	SklTot
enrage	IAV
alright	Intrj
celebration	RspTot
imagination	SklTot
title	FormLw
huge	DIM
willingness	PowTot
envisage	EnlTot
gaudy	Quality
poverty	WltTot
decency	RcTot
enrolment	Source
ding	RcTot
inhabitant	PowTot
free	PowTot
fiftieth	Source
salutary	PosAff
extinct	WlbTot
art	SklTot
enlarge	TrnGain
compulsory	PowTot
invalid	EnlTot
secret	FormLw
fence	IAV
liberate	RcTot
culminate	IAV
hostility	PowTot
yoke	PowTot
adaptable	IndAdj
midst	TimeSpc
demonstration	EnlTot
offensive	IndAdj
depress	Anomie
piano	Tool
borrow	WltTot
boundless	IndAdj
serum	WlbTot
steadfast	Persist
speculate	EnlTot
paramount	SureLw
tune	FormLw
unsurpassable	PosAff
hilly	Land
countless	SureLw
whereby	Causal
sagacity	Know
unabated	Source
nobody	PtLw
imitation	SocRel
scottish	Nation
complexity	EnlTot
chinese	Nation
marital	AffTot
flown	IAV
reform	PowTot
somehow	Means
sporadic	FREQ
hardship	WlbTot
uppermost	Space
flirt	IAV
relaxation	WlbTot
egg	WlbTot
procedure	ABS
ravage	TrnLoss
aggregation	Quan
livestock	WltTot
absurdity	Vice
moment	TimeSpc
resolved	IndAdj
vicious	NegAff
grass	NatObj
enrichment	Increas
eleven	CARD
rascal	RspTot
aboard	Space
distinguish	EnlTot
extrapolation	Know
meek	IndAdj
dean	EnlTot
aggregate	Quan
hull	Tool
elephant	ANI
peaceable	PowTot
resentment	NegAff
duplication	Know
submerge	IAV
part	If
element	Know
hunter	SklTot
wage	TranLw
comer	HU
stable	MeansLw
lebanon	Nation
metaphysical	Relig
notwithstanding	Know
thoughtfulness	Think
burglary	Fetch
coordinate	PowTot
toss	TranLw
demolish	TranLw
edc	Source
puzzlement	EnlTot
allowance	WltTot
forth	TimeSpc
gruff	IndAdj
exception	PowTot
proceed	EndsLw
nigger	HU
entry	BldgPt
boxer	SklTot
furniture	Tool
shelter	WlbTot
attendant	PtLw
equilibrium	Persist
intellectual	EnlTot
kick	TrnLoss
bountiful	WltTot
discipline	RcTot
hardtack	Food
dissent	Vice
humiliate	NegAff
venerate	IAV
upstairs	BldgPt
slip	DAV
deficient	IndAdj
palatable	IndAdj
alcoholic	WlbTot
indictment	FormLw
discount	IAV
subscription	COLL
cohesion	Rel
history	EnlTot
coarseness	Quality
accomplishment	EndsLw
socialist	PowTot
mediation	PowTot
parliament	PowTot
renaissance	Increas
jeep	Vehicle
complementary	IndAdj
abhor	SV
senegal	Nation
poison	Object
new	FormLw
physician	WlbTot
shameless	IPadj
stunt	Vice
shred	IAV
stormy	IndAdj
offender	RcTot
adulation	Eval@
topic	FormLw
cohort	COLL
weep	WlbTot
driveway	Route
hygiene	Positiv
truthful	RcTot
this	Source
heroine	RspTot
bible	RcTot
telegraph	FormLw
plasticity	Quality
assassination	PowTot
board	FormLw
weigh	TranLw
considerable	SureLw
radar	Tool
gland	WlbTot
boost	TrnGain
misery	WlbTot
commend	RspTot
appreciable	Perceiv
unshaken	SureLw
lone	AffTot
quarter	TimeSpc
eager	PosAff
brace	IAV
sociological	Doctrin
astute	IndAdj
foe	PowTot
pitch	DAV
attachment	PosAff
except	Know
dissatisfied	Anomie
strain	TranLw
peony	NatObj
indian	Nation
disable	IAV
tailor	IAV
indescribable	IndAdj
niche	PLACE
servant	SklTot
eventual	Time@
sheep	ANI
resumption	Begin
gloom	Anomie
object	EndsLw
structure	TranLw
confident	WlbTot
overlap	Source
astronomical	Quan
allure	Virtue
exploration	EnlTot
plight	EMOT
adjacent	TimeSpc
withdrew	PowTot
ostensibly	EnlTot
elemental	Know
admissible	FormLw
offend	RspTot
main	SureLw
unfortunate	EndsLw
animosity	NegAff
justice	RcTot
october	TimeSpc
freshmen	EnlTot
gulf	Aquatic
concern	EnlTot
stand	SureLw
unbearable	IPadj
visitor	EnlTot
tnt	PowTot
taunt	FormLw
brute	HU
facility	MeansLw
favorite	AffTot
favor	PosAff
italian	Nation
edge	WlbTot
ninth	Source
stove	Tool
provoke	PowTot
peaceful	PowTot
indication	Know
phase	Time@
sold	EnlTot
dead	WlbTot
enunciate	EnlTot
science	FormLw
necessary	SureLw
soar	IAV
nothing	NotLw
unreliability	Negate
stake	Means
kenya	Nation
sweetheart	HU
quicken	IAV
ethos	Source
decorate	IAV
knocker	Tool
premium	IndAdj
gratification	TrnGain
occasion	TimeSpc
jaw	BodyPt
deem	IAV
monstrous	Ovrst
reckless	RspTot
license	COM
dunce	HU
insect	ANI
help	MeansLw
continental	Region
ethics	RcTot
gross	NegAff
harmful	WlbTot
bleed	WlbTot
blemish	Vice
inexcusable	NegAff
joyous	WlbTot
producer	WltTot
movable	Means
inhibition	WlbTot
solicitor	PowTot
arisen	IndAdj
imposition	PowTot
yonder	TimeSpc
northwest	TimeSpc
prussian	Nation
square	TimeSpc
bereft	HU
patent	COM
charm	SklTot
crafty	IndAdj
hedge	If
unaltered	Source
pleasant	PosAff
visionary	Know
classic	TimeSpc
confederate	PowTot
coddle	IAV
extensive	SureLw
player	SklTot
slender	WlbTot
babble	DAV
aide	PowTot
doll	PtLw
kidnap	IAV
remedy	WlbTot
permanent	TimeSpc
aggressive	PowTot
vague	EnlTot
disunion	PowTot
monument	RspTot
cookie	Food
scientific	EnlTot
sweeten	IAV
collusion	IAV
call	FormLw
parkway	Route
citizen	PowTot
mystic	RcTot
lavish	IndAdj
constitutional	POLIT
disease	WlbTot
cherub	HU
haggard	IndAdj
doom	IAV
confound	TrnLoss
stubbornly	IndAdj
immorality	Eval@
jewish	RcTot
anyway	Undrst
weird	IndAdj
queen	RspTot
passe	IndAdj
gray	COLOR
streamer	Tool
sorrowful	IndAdj
deprive	TrnLoss
attend	EnlTot
accomplish	EndsLw
voter	PowTot
promptly	Ovrst
commercial	WltTot
threat	EndsLw
relative	AffTot
framework	TimeSpc
innovate	IAV
glad	WlbTot
repulsive	NegAff
relentless	Vice
fail	SklTot
balmy	IndAdj
revelation	Solve
tariff	WltTot
friday	TimeSpc
verse	COM
earth	SureLw
era	TimeSpc
other	TimeSpc
accept	PosAff
squander	IAV
transit	Travel
melancholy	WlbTot
sworn	PowTot
articulate	FormLw
destruction	TrnLoss
station	PowTot
primarily	IndAdj
dress	DAV
gesture	FormLw
anchor	IAV
arouse	Source
dahomey	Nation
elapse	TimeSpc
haunt	IAV
marsh	Land
useless	NegAff
label	EnlTot
implication	EndsLw
slipper	Tool
ladder	Tool
bet	FormLw
likelihood	Causal
tunnel	Route
dote	IAV
generalise	Source
destiny	EndsLw
constitution	PowTot
restless	WlbTot
bitter	WlbTot
aggrieve	SV
county	PowTot
cooperation	PowTot
first	TimeSpc
whole	If
convenient	PosAff
harassment	Exert
atrophy	TrnLoss
mentality	EnlTot
unusual	SureLw
infant	WlbTot
ignore	EnlTot
adventure	Travel
festive	IndAdj
postpone	If
depose	IAV
march	TimeSpc
war	PowTot
an	Source
incompetence	SklTot
june	TimeSpc
ugh	Intrj
foot	TimeSpc
tiresome	IndAdj
content	TrnGain
covert	IndAdj
salt	Food
mill	Anomie
inflict	PowTot
as	Quan
forthwith	TimeSpc
shameful	IPadj
overly	Quan
circle	TimeSpc
permanence	Source
stay	DAV
bed	IAV
overture	Virtue
complicity	Vice
grace	Relig
oppression	PowTot
preferable	PosAff
violation	RcTot
article	FormLw
congested	IndAdj
evidence	EnlTot
enthusiastic	PosAff
persevere	RcTot
deer	ANI
assist	PowTot
discord	PowTot
assault	PowTot
emphatic	SureLw
embarrassed	TrnLoss
haggle	PowTot
frozen	Quality
impulsive	IndAdj
massive	DIM
unrest	Vary
gravest	Source
minnesota	Source
donate	DAV
pretend	TranLw
supportive	IPadj
butter	Food
anger	WlbTot
forsake	IAV
blow	PowTot
payroll	WltTot
sweep	TranLw
colorful	COLOR
kiss	FormLw
beautiful	SklTot
less	Quan
customary	RcTot
morality	RcTot
bankruptcy	WltTot
cynical	Vice
truth	EnlTot
literary	SklTot
wee	IndAdj
infest	IAV
imperialism	PowTot
aircraft	Vehicle
anticipation	Arousal
unimpaired	Source
remodel	IAV
togo	Nation
collapse	NegAff
credulity	EnlTot
offset	IAV
prevail	PowTot
drew	DAV
protect	TrnGain
adjoin	Stay
confide	RspTot
cuban	Nation
stain	DAV
salami	Food
humorous	WlbTot
sweat	TranLw
restlessness	EMOT
incompatibility	PowTot
imaginative	SklTot
ardour	AffTot
insistence	FormLw
shot	TrnLoss
ethnic	Race
odds	EndsLw
maple	NatObj
heap	IAV
inconsistent	EnlTot
thoughtless	IndAdj
utilitarian	IndAdj
score	IAV
film	IAV
instead	Rel
north	TimeSpc
termination	TimeSpc
outcome	TranLw
lip	WlbTot
outdoor	Region
delinquent	RcTot
brood	SV
missionary	RcTot
quaint	Virtue
smitten	SV
patriotic	IndAdj
repose	IAV
apparent	If
whimsical	IndAdj
flee	IAV
a	Source
abundance	WltTot
grandpa	AffTot
misrepresent	IAV
presidency	PowTot
lazy	Vice
outrageous	IndAdj
exuberance	Ovrst
complain	IAV
yard	TimeSpc
possess	PowTot
incredible	Negate
suspend	IAV
grease	IAV
clandestine	EnlTot
immaculate	IndAdj
toleration	RcTot
neurotic	IndAdj
dominate	PowTot
staunchness	Persist
warlike	IPadj
joy	WlbTot
italy	Nation
regional	PowTot
dialogue	FormLw
known	EnlTot
leader	PowTot
costume	Tool
female	WlbTot
technological	EnlTot
inherent	MeansLw
bastard	RspTot
hundred	CARD
misuse	Fail
bottle	Tool
playmate	HU
compound	IAV
nurture	IAV
pastoral	Region
demonstrate	EnlTot
limitation	EnlTot
roofer	SklTot
clung	IAV
salesmanship	WltTot
horrify	IAV
outline	FormLw
determine	SureLw
gait	Quality
favorable	PosAff
comfort	WlbTot
suffice	TranLw
vain	SklTot
pernicious	NegAff
infraction	Legal
word	FormLw
yeah	Intrj
breaker	Aquatic
transfer	PowTot
emphasise	Source
scuffle	Exert
esoteric	IndAdj
brilliance	Quality
emergency	Vice
distinction	EnlTot
flashlight	Tool
quote	TranLw
dull	EnlTot
regression	TranLw
sight	IAV
dealt	Source
immediate	TimeSpc
policemen	PowTot
arrest	PowTot
restrain	PowTot
hallowed	IndAdj
clothe	WlbTot
small	DIM
extreme	SureLw
mobilize	IAV
incurable	IndAdj
ascertainment	EnlTot
cataclysm	Finish
agonize	SV
soever	Source
adversity	Vice
canada	Nation
ministry	HU
prescription	FormLw
daily	TimeSpc
prohibitive	Ovrst
venture	EndsLw
heedless	IndAdj
wily	IndAdj
appreciation	RspTot
gold	WltTot
posse	PowTot
advantageous	MeansLw
horizon	Sky
strong	PowTot
internal	TimeSpc
redundancy	Eval@
bridge	SklTot
ghana	Nation
stiff	Quality
fort	Social
ground	MeansLw
comforter	WlbTot
trustworthy	RspTot
bland	IndAdj
thankful	IPadj
rhodesia	Nation
bless	FormLw
spun	DAV
probable	If
commitment	RcTot
novelty	Ovrst
glance	DAV
memory	EnlTot
perilous	NegAff
shrew	HU
no	FormLw
vagueness	EnlTot
equity	FormLw
ten	CARD
softness	Quality
prod	IAV
concentrate	IAV
clearness	Perceiv
restitution	RcTot
insure	EndsLw
unspeakable	NegAff
discretion	Virtue
comprehension	EnlTot
quiet	TranLw
conviction	RcTot
democrat	PowTot
hut	Social
inch	TimeSpc
delivery	TrnGain
gravity	NatrPro
attendance	Stay
nationality	PowTot
aggression	PowTot
atomic	NatObj
site	TimeSpc
destroyer	PowTot
nosey	IPadj
festivity	Ritual
pearl	Tool
shaken	Source
comparative	EnlTot
tremble	NegAff
analogous	Know
acceptable	PosAff
band	PtLw
senior	EnlTot
generation	PowTot
stab	DAV
exchequer	WltTot
stranger	AffTot
analogy	EnlTot
expiration	Source
fierce	IndAdj
plug	DAV
favourite	Source
physical	WlbTot
wedding	AffTot
philosophical	EnlTot
banter	FormLw
hesitancy	If
defensive	PowTot
symptom	WlbTot
violin	Tool
instruction	FormLw
nicaragua	Nation
futility	Anomie
fry	IAV
unforeseen	IndAdj
communist	PowTot
hundredth	Source
sympathize	AffTot
all	SureLw
crass	IndAdj
map	TimeSpc
passenger	HU
drowsiness	NatrPro
idleness	Stay
coherent	IndAdj
notice	EnlTot
plow	IAV
indistinct	Negate
bolster	IAV
trader	WltTot
compute	EnlTot
thereby	Causal
strip	TrnLoss
newsmen	EnlTot
acclaim	ComForm
number	TranLw
burglar	Fetch
attacker	PowTot
trip	TrnLoss
captive	IPadj
adolescent	WlbPt
side	TimeSpc
disruption	Vice
toilet	BldgPt
radiation	NatrPro
starvation	WlbTot
poisonous	IPadj
employment	WltTot
absorb	Means
practical	If
prelude	TimeSpc
unsuitable	NegAff
touchy	IndAdj
drought	Quan
debatable	EnlTot
bout	PowTot
enforce	PowTot
available	Virtue
responsible	RcTot
southern	TimeSpc
gallantry	Virtue
troop	PowTot
ruler	PowTot
rumor	EnlTot
participate	PowTot
annoyance	NegAff
customer	WltTot
tribute	FormLw
region	ArenaLw
fame	RspTot
absentee	Fail
incomparable	EnlTot
mind	IAV
refund	FormLw
diameter	TimeSpc
reverently	Ought
compile	EnlTot
reporter	EnlTot
burial	WlbTot
steal	RcTot
that	Source
intact	Quality
unaware	EnlTot
cute	IndAdj
common	EnlTot
grapple	IAV
thirsty	IndAdj
achievement	EndsLw
faith	RcTot
luxury	WltTot
cry	FormLw
distortion	Perceiv
barely	If
term	FormLw
affiliation	Affil
resolve	PowTot
selection	PowTot
jeopardy	Negativ
naval	PowTot
ordain	RcTot
fearless	IndAdj
encroachment	PowTot
demean	IAV
pregnancy	WlbTot
shun	IAV
weapon	PowTot
went	IAV
abandonment	Fail
victor	PowTot
magic	RcTot
boulder	NatObj
afternoon	TimeSpc
exterminate	IAV
methodical	Means
only	Quan
ample	EndsLw
dangerous	NegAff
peril	Quality
singapore	Nation
scruples	Ought
earnestness	ComForm
justifiably	RcTot
luxuriant	IndAdj
liberal	EnlTot
disclosure	EnlTot
frolic	IAV
ankle	WlbTot
barrier	PowTot
commendable	RspTot
exporter	WltTot
conceal	EnlTot
fluid	NatrPro
channel	IAV
potentiality	EndsLw
strange	Quality
amid	TimeSpc
lay	TrnLoss
ungrateful	RcTot
conservative	PowTot
chill	IAV
lucid	IndAdj
fighter	HU
goodness	RcTot
devise	TrnLoss
outright	IndAdj
beggar	HU
symbolize	IAV
okay	PosAff
canvas	EnlTot
france	Nation
charge	FormLw
instable	If
nepal	Nation
trace	EnlTot
examiner	PowTot
began	EndsLw
difficulty	SklTot
image	Means
democratic	PowTot
locale	TimeSpc
shady	IndAdj
arm	PowTot
portugal	Nation
outspoken	EnlTot
rhythmic	TimeSpc
spur	IAV
corrosive	IPadj
annual	TimeSpc
nonchalant	IndAdj
drain	DAV
lodge	Social
youngster	PtLw
perplexity	Think
market	WltTot
employee	WltTot
feudalism	PowTot
want	EndsLw
alaska	Name
betray	RcTot
wolf	ANI
familiarize	IAV
frank	EVAL
clue	EnlTot
fortify	PowTot
eccentricity	Quality
mule	ANI
arrival	Travel
tory	PowTot
frantic	EMOT
expose	TranLw
desk	PowTot
obnoxious	NegAff
fat	WlbTot
seller	WltTot
soothe	IAV
receiver	HU
trivial	IndAdj
stronghold	PowTot
battlefield	PowTot
session	ArenaLw
livery	Tool
electricity	WltTot
sick	NegAff
maintenance	PowTot
tragedy	TrnLoss
casualty	Finish
juncture	Source
hapless	IndAdj
ourselves	Our
applause	FormLw
london	PowTot
rebate	WltTot
costa	Nation
reiterate	EnlTot
conjunction	PowTot
billion	WltTot
observer	EnlTot
disapproval	Eval@
discrepancy	Know
current	TimeSpc
nebulous	IndAdj
inexplicable	Negate
replace	TranLw
alabama	Source
inning	Time@
precept	Doctrin
statement	FormLw
strategy	EndsLw
reef	Land
attentive	Perceiv
utter	TranLw
bring	TranLw
brat	IndAdj
assent	PowTot
festival	AffTot
just	TimeSpc
comic	HU
context	ArenaLw
propitious	Virtue
grotesque	NegAff
anarchy	Anomie
constraint	FormLw
along	TimeSpc
chearful	WlbTot
merchandise	WltTot
volunteer	TranLw
outside	TimeSpc
yesterday	TimeSpc
obvious	SureLw
correspond	IAV
city	ArenaLw
climax	Finish
entertain	IAV
armistice	PowTot
jazz	FormLw
devil	RcTot
broker	WltTot
indifferent	IndAdj
gullible	IPadj
syndicate	HU
godliness	Virtue
excellent	PosAff
satisfactorily	RcTot
systematic	Means
sensible	EnlTot
camel	ANI
february	TimeSpc
proper	RcTot
climate	ArenaLw
unreal	Negate
response	FormLw
dug	Source
rubbish	Object
dreamt	EndsLw
criticize	RspTot
legitimate	PowTot
gauge	EnlTot
chronic	Ovrst
academic	EnlTot
disgust	NegAff
observe	EnlTot
workable	Virtue
creek	Aquatic
unstable	If
will	PowTot
ghastly	NegAff
contemplate	EnlTot
equivocal	If
hold	WltTot
installation	Work
prance	IAV
sanctuary	Region
angle	Space
outbreak	Travel
cheerful	WlbTot
utopian	EndsLw
noise	EnlTot
individuality	RspTot
purify	IAV
classroom	EnlTot
surgeon	WlbTot
transmit	TranLw
mathematics	EnlTot
cover	IAV
tension	EMOT
wise	EnlTot
bath	Tool
worthy	RcTot
angry	WlbTot
japanese	Nation
unbind	TranLw
situate	TranLw
origin	Begin
morocco	Nation
businessman	WltTot
journalist	EnlTot
glimmer	IAV
bonus	FormLw
thou	You
conceit	Vice
king	PowTot
ecstasy	EMOT
paper	COM
maxim	RcTot
hague	Source
skirmish	Exert
trait	Know
doomsday	Finish
befitting	IndAdj
language	FormLw
colleague	PowTot
connection	Space
width	TimeSpc
flourish	WlbTot
redundant	IndAdj
testify	EnlTot
austrian	Nation
animation	Quality
omission	Means
coarse	IndAdj
prowl	IAV
cozy	IndAdj
assassin	Exert
impostor	RcTot
irrefutable	SureLw
inventive	SklTot
magical	IndAdj
correlation	Know
replenish	TrnGain
trap	PowTot
bait	IAV
hack	HU
singly	Quan
amazement	Power
inadequacy	MeansLw
revolutionary	PowTot
adornment	Eval@
crude	SklTot
yours	You
boldness	Virtue
fate	EndsLw
loom	IAV
bull	ANI
newborn	WlbTot
instruct	EnlTot
berlin	PowTot
desirable	EndsLw
ban	PowTot
mental	WlbTot
innovation	SklTot
priority	EndsLw
cosmic	RcTot
momentary	TimeSpc
widespread	TimeSpc
bewilderment	EnlTot
veto	DAV
combatant	IPadj
amiability	Virtue
involve	TranLw
anybody	Ovrst
composer	SklTot
buddy	AffTot
rock	FormLw
command	FormLw
true	SureLw
leakage	Decreas
mismanagement	RcTot
wondrous	IndAdj
typical	EVAL
hierarchy	PowTot
fare	FormLw
dislike	NegAff
confine	PowTot
tactics	Means
lament	SV
nihilism	Anomie
durability	Stay
momentous	IndAdj
sixth	Source
impediment	PowTot
surge	Increas
banker	WltTot
conflict	PowTot
grandchild	AffTot
flag	RspTot
amelioration	WlbTot
genetic	NatrPro
boil	DAV
foible	Fail
stun	IAV
brush	IAV
fun	WlbTot
pure	EVAL
finger	TranLw
prevalent	Quan
minimize	IAV
violate	RcTot
lignite	NatObj
sex	AffTot
manslaughter	RcTot
wore	Source
laos	Nation
impose	PowTot
sucker	HU
alive	WlbTot
complication	Vice
everybody	Ovrst
straggler	Weak
sang	TranLw
wretchedness	Eval@
loser	RspTot
abroad	TimeSpc
theoretical	EnlTot
draft	IAV
folklore	FormLw
embassy	PowTot
date	TimeSpc
reliability	Ovrst
amiss	NegAff
within	TimeSpc
disc	Tool
punish	TrnLoss
blue	FormLw
concurred	Source
congregational	RcTot
badly	NegAff
relief	WlbTot
credit	FormLw
embarrass	IAV
resolution	FormLw
desirous	IndAdj
predict	EnlTot
audacity	Ovrst
monumental	IndAdj
boycott	FormLw
obliterate	IAV
wait	TranLw
fathom	TimeSpc
settlement	PowTot
venomous	IndAdj
compulsive	WlbTot
mcgovern	PowTot
fabric	Tool
temerity	RspTot
dawn	TimeSpc
hollow	Quality
prolific	IndAdj
discover	EnlTot
town	Social
policy	PowTot
sank	TranLw
shape	TranLw
meanwhile	TimeSpc
become	IAV
comprehensive	IndAdj
eighty	CARD
profitable	TrnGain
dire	IndAdj
liver	WlbTot
temperance	Undrst
daunting	IndAdj
bag	IAV
deliberate	IAV
loner	AffTot
residence	Social
everlasting	IndAdj
victim	WlbTot
unpopular	IPadj
undid	TrnLoss
barn	Social
presidential	PowTot
dry	DAV
consequent	EndsLw
axis	Space
standstill	Stay
done	DAV
compatible	PosAff
redhead	HU
cleanliness	Work
defender	HU
economics	WltTot
enter	DAV
flight	Travel
heresy	RcTot
prosecution	PowTot
condemn	NegAff
engage	EndsLw
success	EndsLw
angel	HU
donation	Fetch
propaganda	FormLw
vex	IAV
parachute	SklTot
sizeable	Source
vexatious	NegAff
perish	WlbTot
ecclesiastical	RcTot
spoken	Source
overlying	TimeSpc
administration	PowTot
ranch	WltTot
scapegoat	NegAff
ornament	SklTot
nineteen	CARD
kingdom	PowTot
fascinate	EnlTot
son	AffTot
workingman	WltTot
parish	RcTot
them	Source
gravitate	Source
span	TimeSpc
money	WltTot
anyone	Ovrst
song	FormLw
conventional	Virtue
transference	Source
joiner	PowTot
chance	If
feign	IAV
rhineland	PowTot
depend	If
futile	Anomie
hysterical	WlbTot
constructive	EndsLw
devoid	Know
broke	TrnLoss
personnel	PtLw
rebut	PowTot
child	WlbTot
injure	WlbTot
hospital	WlbTot
country	ArenaLw
enforcement	PowTot
lightning	NatrPro
dearth	Vice
deputy	PowTot
monotony	Eval@
focus	EnlTot
bulgaria	Nation
unconscious	EnlTot
raw	Quality
sabotage	IAV
church	RcTot
crawl	DAV
arkansas	Source
abandon	AffTot
territorial	PowTot
stir	TranLw
fleeting	IndAdj
chile	Nation
accidental	TrnLoss
successor	PowTot
vexation	Think
alongside	TimeSpc
notion	EnlTot
frustrate	TrnLoss
stricken	IndAdj
encompass	IAV
month	TimeSpc
thrown	Source
myself	Source
gather	TrnGain
vessel	Vehicle
obscure	EnlTot
treasury	WltTot
shoulder	TranLw
fanatical	IndAdj
overjoy	WlbTot
flounder	IAV
balk	IAV
leadership	PowTot
recreate	WlbTot
lower	TranLw
chair	Tool
upfront	IndAdj
reliable	IndAdj
emerge	PowTot
beam	IAV
starter	Tool
allocation	FormLw
christianity	RcTot
freshman	EnlTot
precinct	PowTot
snare	Fetch
monster	ANI
receive	TranLw
interior	TimeSpc
bend	DAV
competition	PowTot
mobile	Travel
chafe	IndAdj
gasp	FormLw
plaque	RspTot
juvenile	RspTot
adaptive	IndAdj
holland	Nation
jeer	IAV
wishful	EndsLw
steadily	Persist
sardinia	Nation
african	PowTot
expend	WltTot
react	TranLw
mundane	IndAdj
virtual	SureLw
blunder	SklTot
nebraska	Source
deadweight	Stay
reassure	TranLw
mount	TranLw
admiration	RspTot
lack	EndsLw
worldly	Quality
nearby	TimeSpc
bolivia	Source
clinic	WlbTot
honeymoon	Kin@
branch	WltTot
qualification	SklTot
teeth	BodyPt
talk	FormLw
press	EndsLw
california	Name
vigilance	EnlTot
high	TrnGain
application	FormLw
medal	RspTot
collect	TrnGain
voice	FormLw
star	IAV
brandy	Food
diver	SklTot
musical	FormLw
maryland	Source
capitalize	IAV
arena	Social
whim	Vary
convey	WltTot
how	Quality
questioner	EnlTot
damage	TrnLoss
blanket	Tool
rice	Food
smoky	Quality
conquest	PowTot
hungry	WlbTot
register	TranLw
soundness	Virtue
december	TimeSpc
purely	SureLw
rake	DAV
rang	DAV
color	PowTot
try	TranLw
kid	RspTot
uproot	IAV
straightforward	IndAdj
situation	ArenaLw
jail	DAV
plaything	Object
owner	WltTot
surinam	Nation
immobility	Stay
attraction	Pleasur
irresponsible	RcTot
painter	SklTot
decent	PosAff
personality	WlbTot
quench	IAV
dissolution	Perceiv
comeback	Increas
mexican	Nation
communion	RcTot
stately	RspTot
sail	TranLw
specialisation	Source
abyss	Land
firm	WltTot
absorbent	IndAdj
impressive	RspTot
noble	RspTot
guise	Perceiv
staunch	RspTot
extermination	Finish
camera	Tool
provide	If
oneself	Self
idolize	SV
skies	Sky
sloppy	IndAdj
architect	SklTot
broadness	Space
coincident	Rel
exquisite	IndAdj
weather	Sky
vanish	TranLw
bereavement	Vice
beastly	IndAdj
chaste	IndAdj
thence	Space
hip	BodyPt
instigate	TranLw
arid	NegAff
poor	NegAff
porch	BldgPt
veil	Tool
counterfeit	IndAdj
interruption	FormLw
commence	IAV
accusation	ComForm
thief	RcTot
resistance	PowTot
bite	IAV
prodigious	IndAdj
mysterious	EnlTot
bourgeoisie	PowTot
antagonism	NegAff
september	TimeSpc
grown	WlbTot
governmental	PowTot
multiply	TranLw
whatever	Intrj
mover	SklTot
mate	AffTot
assert	PowTot
outpost	PowTot
ballot	PowTot
abyssinia	Nation
style	Quality
everything	Ovrst
conclusive	IndAdj
unification	PowTot
vary	TranLw
profound	EVAL
admirable	RspOth
unparalleled	SureLw
excuse	FormLw
rigorous	IndAdj
presentation	FormLw
elaborate	IAV
dentist	WlbTot
mild	IndAdj
embody	Source
censure	IAV
determination	PowTot
sanctity	RspTot
immoral	IndAdj
blossom	IAV
order	FormLw
revert	TranLw
managerial	SklTot
grey	COLOR
reproach	IAV
uncomfortable	WlbTot
hire	WltTot
murmur	FormLw
avoidance	If
glory	PosAff
fifteenth	Rel
bold	Virtue
censor	IAV
cynicism	IndAdj
jeopardise	Source
clarity	EnlTot
notorious	RcTot
jordan	Nation
sociable	IPadj
desert	RcTot
absolve	IAV
dumb	FormLw
overlook	EnlTot
insidious	NegAff
request	FormLw
ahead	TimeSpc
amputate	IAV
furnace	Tool
generalize	EnlTot
obstruct	EndsLw
molecular	NatObj
authority	EnlTot
careful	If
technician	SklTot
temptation	RcTot
dismiss	PowTot
repel	PowTot
obscurity	EnlTot
gladden	WlbTot
calendar	TimeSpc
mistaken	IAV
cheerfulness	WlbTot
displace	PowTot
harmonious	PowTot
christmas	AffTot
doubt	If
guardian	PowTot
awe	RcTot
enslave	IAV
belated	IndAdj
lieutenant	PowTot
say	FormLw
banquet	RspTot
fork	Tool
declaration	FormLw
rich	WltTot
beseech	IAV
noteworthy	RspTot
infiltration	PowTot
young	Time@
gentleman	RspTot
bigotry	RspTot
faction	PowTot
forgotten	EnlTot
distraction	Ovrst
premise	Causal
accentuate	IAV
sir	RspTot
demo	Source
enjoy	WlbTot
us	Our
approach	EnlTot
realistically	Ovrst
blockhead	IndAdj
manifest	TranLw
submissive	IPadj
horrid	IndAdj
fear	WlbTot
superlative	EVAL
temperature	Quality
amusement	WlbTot
mph	TimeSpc
regularity	TIME
builder	SklTot
rehabilitation	Solve
bloodshed	Pain
log	NatObj
affluence	WltTot
irrigate	WltTot
translate	EnlTot
dynamic	WlbTot
beaten	Source
backing	Affil
stale	IndAdj
praise	FormLw
separation	TrnLoss
danger	NegAff
incessant	Persist
seen	TranLw
health	WlbTot
pakistan	Nation
snow	TrnLoss
dust	NatObj
earthquake	WlbTot
inconvenient	NegAff
zealand	Nation
fall	TimeSpc
woo	IAV
derisive	IndAdj
hole	WltTot
numb	IndAdj
repeal	PowTot
fox	ANI
wayward	IndAdj
damn	NegAff
patient	PosAff
confrontation	PowTot
tatter	IAV
acquisition	TrnGain
hampshire	Source
rural	Region
inevitability	SureLw
rescue	TrnGain
develop	EndsLw
pardon	FormLw
untouched	IndAdj
sorry	WlbTot
boat	Vehicle
partial	Quan
bread	WltTot
incorporate	TranLw
catcher	SklTot
envoy	PowTot
foundation	MeansLw
ninety	CARD
testimony	EnlTot
pollution	POLIT
terrorize	IAV
exhibition	Source
government	PowTot
spare	WlbTot
precious	WltTot
essential	SureLw
guy	AffTot
integrate	PowTot
spear	PowTot
throw	TranLw
contradict	IAV
mock	RspTot
russia	Nation
beneath	TimeSpc
shout	FormLw
witness	PtLw
banal	IndAdj
contrast	IAV
trudge	IAV
dr	RspTot
despondent	Anomie
indecisive	If
illegal	PowTot
precipitate	IAV
bulletin	EnlTot
smoker	HU
fake	IndAdj
target	PowTot
crete	Nation
stole	RcTot
discourse	FormLw
avowal	EnlTot
warfare	PowTot
miser	Fetch
wet	Quality
royalty	WltTot
view	FormLw
link	TranLw
tight	Quality
competitive	PowTot
idiotic	IndAdj
solid	Quality
sensational	EVAL
experience	EnlTot
glimpse	DAV
witch	PtLw
expenditure	FormLw
caution	FormLw
circulate	Source
misbehave	IAV
detain	IAV
rumania	Nation
famine	WlbTot
composition	Source
usurp	PowTot
congratulatory	IPadj
bothersome	NegAff
merge	TranLw
path	EndsLw
whistle	FormLw
dismal	Anomie
devilish	IndAdj
inability	MeansLw
despite	EndsLw
appropriate	WltTot
excellence	EndsLw
detail	EnlTot
mass	TranLw
unworthy	RspTot
mischief	Active
discard	IAV
symbolism	FormLw
thousandth	Source
assemble	PowTot
preliminary	Time@
steamer	Vehicle
litter	Vice
luck	EndsLw
thrifty	IndAdj
sheet	Tool
shudder	DAV
winner	PowTot
interrupt	TrnLoss
head	TimeSpc
zealous	AffTot
intense	SureLw
agitate	PowTot
wednesday	TimeSpc
minute	TimeSpc
philadelphia	Name
payable	TrnGain
moon	Sky
unhappily	WlbTot
maker	SklTot
perverse	IndAdj
yemen	Nation
shrank	RcTot
condense	IAV
keeper	PtLw
white	SureLw
belittle	RspTot
idiot	Eval@
formulate	EnlTot
teach	EnlTot
prefer	PosAff
entrust	TrnGain
where	TimeSpc
corrupt	RcTot
jeopardize	IAV
petition	PowTot
startle	WlbTot
threw	Source
police	PowTot
guide	PtLw
jagged	Quality
flattery	ComForm
toe	BodyPt
height	TimeSpc
pelvic	BodyPt
restful	IndAdj
inhibit	WlbTot
pattern	ABS
attention	Perceiv
mourner	HU
plunder	WltTot
commoner	PowTot
clergyman	RcTot
intervention	PowTot
splendor	SklTot
alleviate	TrnGain
mat	Tool
initiate	TranLw
poem	SklTot
analyst	EnlTot
giddy	IndAdj
popularity	SocRel
hopeless	MeansLw
primary	PowTot
half	CARD
abundant	WltTot
return	WltTot
sob	DAV
gossip	FormLw
farce	ComForm
phone	DAV
resource	WltTot
worker	WltTot
rocket	Vehicle
typography	Doctrin
intention	EndsLw
engulf	TranLw
precede	TimeSpc
quit	TranLw
ill	NegAff
loss	TrnLoss
slide	DAV
yell	FormLw
madagascar	Nation
affirmative	Positiv
fulfil	Source
theirs	Source
well	If
belgian	Nation
gratitude	RspTot
reservation	Means
must	SV
evade	If
extent	Rel
fraud	RcTot
civil	PowTot
tranquility	Pleasur
scratch	DAV
consolidation	TranLw
fellowship	AffTot
english	Nation
frightful	IndAdj
himself	MALE
horsemen	PowTot
calamity	WlbTot
pause	TimeSpc
snap	DAV
similarity	Know
parity	WltTot
mexico	Nation
drink	DAV
possessive	PowTot
symbol	FormLw
he	MALE
urgent	EndsLw
havoc	Ovrst
emperor	PowTot
piston	Tool
mob	PowTot
output	WltTot
consultant	EnlTot
plague	TranLw
impartial	RcTot
lyrical	FormLw
coercive	IPadj
unfaithful	IPadj
arbitrary	NegAff
sure	SureLw
appointment	PowTot
rep	Source
harsh	EVAL
selfishness	IPadj
depreciation	WltTot
spiteful	IPadj
republican	PowTot
versus	Rel
respond	PowTot
placement	Space
friendly	AffTot
totem	Source
preferably	PosAff
thorough	SureLw
imperishable	WlbTot
broad	TimeSpc
subsidy	WltTot
molest	IAV
abolish	PowTot
exhibit	FormLw
scant	Quan
sector	TimeSpc
most	Quan
prison	PowTot
spark	NatrPro
zest	Arousal
water	IAV
envy	EndsLw
immovable	IndAdj
calm	WlbTot
fifth	Source
brother	AffTot
heighten	IAV
volume	Source
insinuation	RspTot
intermediate	PowTot
communication	FormLw
aristocrat	HU
detective	PowTot
considerate	IPadj
rusty	IndAdj
force	PowTot
variety	ABS
radical	POLIT
sky	Sky
cigarette	Tool
inclination	Need
unbound	IndAdj
peel	DAV
car	WltTot
sermon	FormLw
dynamism	Source
shipwreck	Object
need	EndsLw
motivated	EndsLw
sarcastic	IPadj
pose	IAV
alienate	IAV
chip	IAV
retreat	PowTot
impression	Perceiv
civilisation	Source
partisan	PowTot
foresight	EnlTot
slander	IAV
cloud	Sky
factual	IndAdj
kind	FormLw
susceptible	IPadj
resign	PowTot
allege	IAV
fly	IAV
fairness	Virtue
unsteadiness	Negate
perspective	EnlTot
thing	NatObj
fraternity	AffTot
seven	CARD
idealism	Think
corpus	COM
racial	HU
even	SureLw
weaken	PowTot
reassert	PowTot
induce	IAV
assuredly	SureLw
hand	IAV
understood	EnlTot
thirty	CARD
malignant	NegAff
corporate	WltTot
listen	EnlTot
renovate	TranLw
refusal	FormLw
written	FormLw
equal	PowTot
incapacity	SklTot
speed	TimeSpc
westerner	PtLw
unchanged	Negate
demise	TranLw
papa	AffTot
adverse	NegAff
scrutinize	IAV
newspaperman	EnlTot
blade	Tool
butchery	Vice
columbia	EnlTot
environment	ArenaLw
necessitate	EndsLw
superintendent	PowTot
assistant	HU
sudden	TimeSpc
colossal	IndAdj
south	TimeSpc
illustration	EnlTot
thwart	PowTot
vegetable	Food
was	Source
fashionable	IndAdj
program	EndsLw
provocation	PowTot
sickly	WlbTot
foregoing	Time@
giant	PtLw
bureaucratic	PowTot
economical	WltTot
unquestionable	SureLw
allegiance	AffTot
jubilee	Ritual
chapel	RcTot
malicious	NegAff
remove	PowTot
prisoner	PowTot
inquire	EnlTot
silhouette	Quality
squeeze	DAV
accommodate	PowTot
elimination	PowTot
boss	PowTot
mere	SureLw
shorten	DAV
impetuous	IndAdj
possession	PowTot
bear	EndsLw
mathematical	EnlTot
readjustment	TranLw
retire	WlbPhys
mankind	AffTot
resentful	IndAdj
roar	FormLw
fabulous	IndAdj
snatch	DAV
stall	TranLw
afford	TrnGain
complex	EnlTot
amuse	WlbTot
eaten	Source
extravagant	MeansLw
fervent	IndAdj
foam	IAV
nuclear	NatrPro
dance	AffTot
subtract	IAV
ancient	TimeSpc
huddle	DAV
pupil	EnlTot
polish	IAV
cultivate	TranLw
lobby	PowTot
bathroom	DAV
shower	IAV
provision	Means
integration	PowTot
heartless	IndAdj
capital	WltTot
reveal	FormLw
extend	TimeSpc
skulk	IAV
gaily	EMOT
biography	FormLw
motivate	IAV
award	FormLw
flux	ABS
righteous	RcTot
cousin	AffTot
doubtless	SureLw
mortgage	FormLw
blah	Intrj
tear	TranLw
text	EnlTot
be	SV
rush	WlbTot
beneficent	IPadj
mantle	Tool
submarine	PowTot
convict	RcTot
when	TimeSpc
shrill	IndAdj
norway	Nation
hero	RspTot
expediency	Source
roller	Tool
expert	SklTot
intolerance	RspTot
turn	NegAff
employ	IAV
injurious	WlbTot
location	ArenaLw
flawless	IndAdj
purification	Work
simple	Quan
forfeit	TrnLoss
transcendant	RcTot
traveler	PtLw
office	PowTot
murky	IndAdj
grief	WlbTot
shabby	IndAdj
disciple	RcTot
anxiety	WlbTot
convention	PtLw
impel	PowTot
familiar	EnlTot
set	ArenaLw
suitcase	Tool
emphasis	SureLw
neighborhood	ArenaLw
annoy	NegAff
repaid	WltTot
repeat	TranLw
temper	IAV
aspiration	Think
finance	WltTot
undone	TrnLoss
value	EndsLw
transformation	Vary
legitimacy	Legal
additional	Quan
anguish	WlbTot
womb	BodyPt
barren	IndAdj
institute	EndsLw
rue	RcTot
insulation	Tool
iraq	Nation
render	TranLw
prestige	RspTot
hiatus	TimeSpc
life	WlbTot
miserable	Anomie
mortify	IAV
mentor	Know
drift	IAV
abject	IPadj
gratify	TrnGain
future	EndsLw
russian	Nation
sleek	IndAdj
dedication	PosAff
insistent	SureLw
sum	TranLw
starve	WlbTot
clock	IAV
prime	IndAdj
redemption	WltTot
send	DAV
welfare	WlbTot
eminence	Ovrst
flat	Space
decorative	IndAdj
protection	TrnGain
wrote	EnlTot
yes	SureLw
epithet	FormLw
haughty	IndAdj
me	Self
astronomy	Doctrin
sexual	AffTot
uttermost	IndAdj
panacea	EndsLw
exclude	TrnLoss
imminent	TimeSpc
impractical	SklTot
admonition	ComForm
protest	PowTot
unkind	IPadj
belong	WltTot
warrior	HU
industrial	WltTot
mesh	IAV
ethiopia	Nation
harbour	Source
prophecy	EnlTot
textile	WltTot
each	Quan
wide	TimeSpc
dare	EndsLw
custom	WltTot
unguarded	IndAdj
journal	EnlTot
vermont	Source
rouse	IAV
instinct	WlbTot
disbelief	Negate
wrap	DAV
chide	IAV
infallible	SureLw
our	Our
buoyant	IndAdj
bureau	PowTot
avail	IAV
atmosphere	ArenaLw
accommodation	PowTot
bavaria	Nation
preserve	TranLw
scrupulous	IndAdj
disaster	Vice
sweden	Nation
disputable	PowTot
mad	SureLw
baker	SklTot
gospel	RcTot
denominational	RcTot
academy	EnlTot
extinguish	TranLw
sour	IndAdj
neighbor	TimeSpc
greatness	RspTot
madman	HU
gone	DAV
nomination	PowTot
sceptical	Source
untold	Negate
slash	TranLw
awful	NegAff
nationalistic	PowTot
etiquette	Ought
bizarre	IndAdj
your	You
regardless	IndAdj
blunt	IPadj
approval	FormLw
cockpit	Tool
wheat	WltTot
feel	EnlTot
topple	IAV
contaminate	IAV
friend	AffTot
independent	PowTot
fullest	Source
version	Know
shrunk	RcTot
nail	TranLw
majesty	Virtue
salvage	TranLw
lowly	IndAdj
garden	WltTot
counterpart	Know
tribe	HU
proponent	PowTot
should	RcTot
consumption	ECON
poet	SklTot
kill	TrnLoss
savings	Econ@
now	TimeSpc
staff	HU
forestry	WltTot
defy	PowTot
reasonable	EnlTot
deposition	FormLw
sentimental	AffTot
tax	FormLw
fasten	IAV
instability	If
evict	IAV
fuss	IAV
clay	NatObj
endurance	WlbTot
swept	DAV
honourable	Source
hindrance	TrnLoss
ineffective	MeansLw
ago	TimeSpc
measureless	Source
ceaseless	IndAdj
explosive	PowTot
vagabond	Travel
conspicuous	Perceiv
lapse	Fail
cuddle	IAV
agitator	Exert
landscape	Land
motel	Social
nation	PowTot
courtesy	Ritual
mangle	IAV
neurosis	WlbTot
stuck	Source
hid	Source
sans	Negate
dedicate	PosAff
yearn	IAV
hideous	NegAff
untrained	IndAdj
expel	IAV
affectionate	AffTot
seriousness	Arousal
liberation	PowTot
clearance	TrnGain
floor	RspTot
abound	IAV
romantic	EMOT
playful	IndAdj
marshall	SklTot
exigency	ArenaLw
wonderful	PosAff
undisputed	SureLw
fortitude	PowTot
justifiable	RcTot
exaggerate	EnlTot
benevolence	PosAff
overthrow	PowTot
rectitude	RcTot
rebuke	RspTot
diversity	Know
proclamation	FormLw
solve	EnlTot
holiday	AffTot
horde	COLL
sympathise	Source
agrarian	Source
swiss	Name
cheat	RcTot
persecution	SocRel
deviate	IAV
uneasiness	If
technique	SklTot
direction	TimeSpc
incipient	Source
smash	TranLw
sort	If
artery	BodyPt
grasp	PowTot
conform	PowTot
sole	Quan
rector	RcTot
judgment	FormLw
none	NotLw
grudge	NegAff
time	DAV
indistinguishable	Negate
betrothal	Exch
patience	ABS
forgetfulness	Think
displacement	PowTot
lemonade	Food
metal	NatObj
haziness	Perceiv
coalition	PowTot
dependency	PowTot
irish	Nation
pale	Quality
certification	FormLw
upheaval	Vary
weekend	TimeSpc
hostile	PowTot
dissatisfaction	NegAff
sadness	WlbTot
downcast	IndAdj
deplore	RcTot
bedroom	BldgPt
endear	IAV
horrifies	TrnLoss
wholesale	FormLw
dauntless	IndAdj
organization	PowTot
salary	WltTot
treatment	Means
harass	IAV
proficient	IndAdj
campaigner	PowTot
crumble	IAV
elevator	BldgPt
turkish	Nation
fiscal	WltTot
divide	PowTot
broken	Source
pious	RcTot
luster	Quality
enormous	DIM
thrust	IAV
participant	PowTot
almighty	RspTot
majestic	IndAdj
limousine	RspTot
contemptible	IndAdj
retardation	Decreas
peerless	IPadj
attest	EnlTot
advocacy	ComForm
taboo	IndAdj
confront	PowTot
garment	WlbTot
prairie	Land
reluctant	If
suggest	FormLw
deject	WlbTot
rate	FormLw
closet	Tool
slothful	IndAdj
crutch	Tool
best	PosAff
cease	DAV
unauthentic	Negate
edinburgh	Name
sleazy	IndAdj
severity	NegAff
queer	IndAdj
apply	EndsLw
british	Nation
grew	Source
conspirator	PowTot
percent	Quan
unprofitable	IndAdj
sheriff	PowTot
oas	Source
ride	TranLw
carelessness	Vice
blame	RcTot
dream	EndsLw
carpenter	SklTot
christian	RcTot
suicide	WlbTot
irk	WlbTot
attract	IAV
soup	Source
although	Source
so	Quan
woke	Source
lick	DAV
sovereign	PowTot
sublime	RspTot
coal	WltTot
accompaniment	SocRel
arrow	Tool
overland	TimeSpc
manifestation	Know
habitual	Persist
rugged	Quality
faithful	AffTot
specialist	HU
string	Tool
belt	IAV
dejected	IndAdj
dresser	Tool
amplify	DAV
candor	ComForm
tenant	WlbTot
tour	IAV
inner	TimeSpc
searcher	EnlTot
narrow	DIM
decrease	TrnLoss
human	AffTot
obtainable	IndAdj
lent	WltTot
confidant	HU
latin	Nation
beyond	TimeSpc
crooked	IndAdj
man	AffTot
matchless	IndAdj
manly	WlbTot
efficient	SklTot
isolate	PowTot
counsel	EnlTot
liable	IndAdj
misunderstand	EnlTot
exert	EndsLw
detach	Source
wine	Food
drank	DAV
intimidate	IAV
conciliation	PowTot
fortune	PosAff
plant	WltTot
prove	SureLw
glove	Source
poster	EnlTot
digital	FormLw
patch	IAV
corsica	Nation
pension	WltTot
intangible	Negate
inquisitive	IndAdj
parade	DAV
seashore	Land
failure	SklTot
prescribe	PowTot
instant	TimeSpc
banish	PowTot
junk	Quality
languish	SV
ineffectiveness	Stay
flame	NatrPro
constable	PowTot
culpable	IndAdj
underway	Persist
utmost	SureLw
heel	BodyPt
reduce	TranLw
scene	Land
suspicious	If
novice	IndAdj
importance	EndsLw
sly	SklTot
contamination	Vice
fiend	HU
iowa	Source
possibility	If
unclear	EnlTot
align	PowTot
reverend	RcTot
meant	EnlTot
negro	HU
district	Source
hind	Space
nope	Intrj
willing	PowTot
traitor	Fail
accrue	DAV
alight	IndAdj
expedition	Travel
external	Space
reconcile	IAV
discouragement	Decreas
scorn	NegAff
apology	FormLw
shrivel	IAV
spin	DAV
doorway	BldgPt
wearer	HU
medieval	Time@
screw	IAV
recession	Decreas
growth	EndsLw
stupendous	IndAdj
organize	PowTot
undivided	Source
equate	EnlTot
perturb	If
controversial	FormLw
civilise	Source
monarch	PowTot
fled	IAV
actuality	SureLw
proffer	IAV
careen	IAV
marine	PowTot
unknown	EnlTot
inundate	IAV
aside	If
impulse	Arousal
thousand	CARD
childhood	WlbTot
oregon	Source
wheel	IAV
add	TrnGain
guardianship	PowTot
born	WlbTot
seato	Source
radiate	IAV
porter	PtLw
final	TimeSpc
suburb	Region
legal	PowTot
hidden	EnlTot
grand	PosAff
analyse	Source
work	SklTot
slight	FormLw
delegation	PowTot
procure	TrnGain
beckon	IAV
superior	PowTot
priest	RcTot
altogether	SureLw
idaho	Source
basic	SureLw
lady	RspTot
granny	AffTot
deaf	IndAdj
brightness	Quality
contrive	PowTot
lad	PtLw
knee	WlbTot
farther	Space
supplementary	Source
dump	NegAff
sullen	IndAdj
liberalism	PowTot
harvest	WltTot
sore	IndAdj
violent	WlbTot
coercion	ComForm
unfeeling	IndAdj
reprisal	PowTot
newcomer	PtLw
pet	ANI
advice	FormLw
bacon	Food
brawl	IAV
greed	RcTot
entreat	IAV
sunk	DAV
indonesia	Nation
galley	BldgPt
collateral	WltTot
jumpy	IndAdj
arose	IAV
fur	WltTot
diminish	TranLw
realism	EnlTot
however	If
river	Aquatic
about	TimeSpc
flew	IAV
objection	ComForm
treasurer	WltTot
cling	IAV
heir	PtLw
leg	WlbTot
machine	SklTot
sound	PosAff
accursed	IPadj
hazy	IndAdj
efta	Source
shake	TranLw
disarmament	PowTot
amen	Intrj
chore	Means
affirmance	TrnGain
duty	RcTot
castrate	TrnLoss
apathetic	IndAdj
feed	WlbTot
wax	IAV
dignify	IAV
story	FormLw
heal	WlbTot
rhode	Source
welcome	FormLw
descend	DAV
rode	DAV
checker	Tool
iceland	Nation
somber	IndAdj
amour	EMOT
penny	WltTot
after	TimeSpc
equitable	RcTot
trophy	Object
lunch	Food
restraint	PowTot
wickedness	Hostile
deviation	Negativ
delirium	Think
charitable	AffTot
overtures	PowTot
condemnation	Eval@
woeful	IndAdj
disturb	If
creep	DAV
degenerate	Ovrst
apartment	BldgPt
kremlin	Nation
mix	TranLw
mourn	WlbTot
unfavourable	Source
malta	Nation
eminent	EVAL
consciousness	EnlTot
fabrication	ComForm
furthermore	Intrj
exclamation	FormLw
solution	EnlTot
else	Know
impoverish	WltTot
regal	IndAdj
headquarters	Social
unite	TranLw
devastation	Vice
capture	PowTot
defiant	IPadj
display	EnlTot
precise	SureLw
cheer	WlbTot
excess	Quan
hang	TranLw
suffocate	IAV
blind	EnlTot
derive	IAV
under	TimeSpc
flood	TranLw
scarce	WltTot
encounter	FormLw
island	ArenaLw
damnable	IndAdj
skirt	Tool
preference	PosAff
report	FormLw
audible	IndAdj
wearisome	IndAdj
heavenly	EVAL
carry	EndsLw
delinquency	RcTot
korea	Nation
gambia	Nation
inland	Source
assurance	FormLw
pessimistic	IndAdj
expand	EndsLw
remain	TranLw
flash	IAV
furious	WlbTot
costliness	Econ@
decipher	IAV
seventy	CARD
on	Space
mellow	IndAdj
recriminate	NegAff
soul	RcTot
effectiveness	SklTot
nobility	HU
negation	NotLw
persian	Nation
melodramatic	FormLw
characterise	Source
impatience	WlbTot
ussr	Nation
stern	NegAff
malaya	Nation
cognizance	Perceiv
abominable	IndAdj
consume	DAV
generate	DAV
ominous	EndsLw
kilometer	TimeSpc
refuge	Pleasur
meaning	EnlTot
tall	TimeSpc
forbid	FormLw
enroll	TranLw
cocky	IndAdj
village	ArenaLw
twin	HU
prosecute	PowTot
optional	IndAdj
metropolitan	Region
speech	FormLw
occur	TranLw
enlist	PowTot
correspondent	EnlTot
various	Quan
politics	PowTot
birth	WlbTot
darn	Intrj
mast	Tool
promotion	TrnGain
departure	Travel
poise	RspTot
confiscation	Fetch
strength	PowTot
indecent	IndAdj
rose	WlbTot
animate	EndsLw
of	Source
reaffirm	SureLw
agricultural	WltTot
answer	FormLw
ruffian	HU
deterred	PowTot
torment	IAV
contend	PowTot
modern	SklTot
epidemic	Quality
raise	TranLw
temperate	IndAdj
squad	HU
refuse	NotLw
adult	WlbTot
engineer	SklTot
hat	Tool
luggage	Tool
unsatisfactory	NegAff
republic	PowTot
easy	SureLw
dent	DAV
detect	EnlTot
unmoved	IndAdj
matriculate	EnlTot
atrocious	NegAff
sin	RcTot
frail	Vice
honduras	Nation
reflect	EnlTot
innocence	RcTot
impatient	WlbTot
nigeria	Nation
southwest	TimeSpc
waiter	HU
improbability	Negate
broaden	TimeSpc
publish	EnlTot
turbulent	IndAdj
couple	AffTot
alarming	IndAdj
denial	FormLw
device	MeansLw
befriend	IAV
guatemala	Nation
amidst	TimeSpc
snore	DAV
many	Quan
adequate	EndsLw
illiterate	IndAdj
method	MeansLw
landlord	PowTot
corruption	RcTot
civilian	PowTot
magnify	TranLw
made	IAV
decompose	IAV
distance	TimeSpc
infantry	PowTot
bottom	TimeSpc
from	Source
rhodesian	Nation
partnership	PowTot
fulfillment	EndsLw
monday	TimeSpc
guidance	PowTot
court	AffTot
told	EnlTot
expulsion	PowTot
generalization	EnlTot
adhesion	Rel
joint	PowTot
sap	HU
fatigue	WlbTot
dignity	RspTot
antagonize	NegAff
identify	EnlTot
appreciative	IPadj
rearrangement	Source
recovery	Complet
neutral	PowTot
snarl	NegAff
consumptive	Vice
pompous	IndAdj
bowl	IAV
suspense	Arousal
serious	SklTot
sudan	Nation
intellect	EnlTot
deceit	Eval@
sword	PowTot
analytic	EnlTot
montana	Source
moreover	Ovrst
below	TimeSpc
service	WlbTot
unobserved	IndAdj
handsome	SklTot
senate	PowTot
liquidate	TrnLoss
castle	PowTot
crushing	IndAdj
think	EnlTot
sarcasm	ComForm
task	SklTot
adjudication	FormLw
writer	EnlTot
preach	FormLw
clerk	SklTot
bat	DAV
answerable	Source
abate	TranLw
mouth	TimeSpc
cement	SklTot
baptism	Doctrin
formula	ABS
uranium	NatObj
prosperity	WltTot
unforgettable	IndAdj
curve	TimeSpc
bitten	Source
unwise	EnlTot
steadiness	Persist
insubordination	PowTot
guarantor	RcTot
commonwealth	HU
elongated	TimeSpc
contribute	TrnGain
imposture	RcTot
spite	NegAff
happy	PosAff
bit	IAV
proportional	Quan
runner	SklTot
maid	SklTot
axle	Tool
aristocracy	HU
sanctify	IAV
functional	Know
imprisonment	Legal
pregnant	WlbTot
compatriot	PowTot
manage	EndsLw
relation	AffTot
fuzzy	EnlTot
rear	IAV
belief	EnlTot
unconditional	SureLw
unqualified	Negate
ballet	SklTot
arrangement	PowTot
meet	FormLw
mud	NatObj
myriad	Quan
rod	Source
able	MeansLw
undoubted	SureLw
favour	Source
chase	DAV
geneva	PowTot
via	Space
special	EVAL
sultan	PowTot
gape	Source
reconstruction	TrnGain
quest	TranLw
primitive	Vice
oblige	RcTot
egotistical	IndAdj
communicative	FormLw
covet	SV
denmark	Nation
businessmen	WltTot
fresh	Time@
injunction	FormLw
anoint	DAV
possible	If
financial	WltTot
metaphysics	Relig
symmetry	Quality
essence	Know
helper	WlbTot
sharp	SureLw
conspiracy	PowTot
require	PowTot
fan	IAV
rancher	WltTot
thin	DIM
cautious	Undrst
sixteen	CARD
deceitful	IPadj
onward	Travel
chancellor	PowTot
overcrowding	WlbTot
terrific	WlbTot
enough	SureLw
authoritarian	NegAff
cage	PowTot
doctor	SklTot
dubious	If
comfortable	WlbTot
bird	ANI
unfriendly	IPadj
grammar	EnlTot
mischievous	IndAdj
relieve	TranLw
scoff	IAV
dissimilar	Negate
laudable	IPadj
reclamation	WltTot
stimulation	Perceiv
tenacity	Means
congregate	IAV
difficult	SklTot
negligence	Eval@
sequester	IAV
champion	SklTot
ledge	Land
sat	Source
gallant	IndAdj
religious	RcTot
oversea	TimeSpc
hell	RcTot
domination	PowTot
rub	DAV
compete	PowTot
perpetual	TimeSpc
scald	IAV
gully	Land
defect	Vice
do	EndsLw
ease	IAV
comment	FormLw
abdicate	IAV
robber	Fetch
unwilling	Negate
scenery	Land
creature	ANI
eldest	RspTot
indeterminable	IndAdj
sometime	TimeSpc
marvelous	PosAff
marksman	SklTot
utility	EndsLw
dimension	EnlTot
semblance	EnlTot
rightful	RcTot
retention	Rel
daring	IndAdj
variable	Know
nationalism	PowTot
incidence	Source
legislative	PowTot
definition	Know
upon	TimeSpc
whimper	DAV
bullet	PowTot
nose	BodyPt
ancestor	RspTot
jewel	SklTot
penalty	RcTot
conducive	TrnGain
busybody	ComForm
kin	AffTot
pentagon	PowTot
intent	EndsLw
officiate	PowTot
parlor	BldgPt
kentucky	Source
pollute	IAV
write	FormLw
precarious	EndsLw
authorize	PowTot
detract	IAV
care	AffTot
elderly	Time@
tent	Social
modification	TranLw
roosevelt	PowTot
corp	PowTot
trustworthiness	Virtue
radiant	IndAdj
writhe	IAV
foreboding	IndAdj
widen	TimeSpc
transom	Tool
exchange	FormLw
system	PowTot
drab	IndAdj
ignition	NatrPro
room	WlbTot
inauguration	Ritual
attempt	EndsLw
marriage	AffTot
rave	IAV
introduce	TranLw
illustrate	EnlTot
seaman	SklTot
announcement	FormLw
deadlock	PowTot
ventricle	WlbTot
uphold	PowTot
experimenter	SklTot
transform	PowTot
july	TimeSpc
cheater	HU
reserve	EndsLw
impute	Source
rejoice	PosAff
stuff	IAV
unfair	RcTot
whig	Source
bravado	Power
advise	IAV
minimum	Quan
project	EndsLw
auto	WltTot
chairmen	PowTot
crash	IAV
bar	AffTot
penetration	PowTot
pick	RspTot
opinion	FormLw
pray	RcTot
met	Source
follower	PowTot
scar	BodyPt
ferocious	IndAdj
excited	WlbTot
unmistakable	SureLw
beset	IndAdj
entitle	RspTot
hysteria	Vice
ripen	IAV
ascendancy	PowTot
palace	Social
skill	SklTot
been	SV
serve	MeansLw
grandma	AffTot
public	PowTot
basis	Know
fruitful	EndsLw
tradition	RspTot
repudiate	RspTot
utilize	EndsLw
track	TranLw
unexpected	If
meaningful	EnlTot
liquor	WlbTot
get	DAV
raid	PowTot
toast	TranLw
truck	Vehicle
hereditary	Source
twilight	TIME
fight	PowTot
activity	EndsLw
fantasy	Perceiv
pulse	NatrPro
breakdown	PowTot
electric	WltTot
convulse	IAV
charter	PowTot
theology	RcTot
dominican	Nation
annihilate	IAV
bashful	IPadj
ocean	Aquatic
division	PowTot
doer	SklTot
holy	RcTot
treat	PosAff
clarification	EnlTot
relax	WlbTot
sprawl	IAV
bother	NegAff
mobility	Positiv
sufficient	Virtue
thrift	Quality
desperation	EMOT
effective	SklTot
segregation	PowTot
privileged	IndAdj
third	Rel
faculty	SklTot
profession	SklTot
solar	Region
admire	RspTot
measurement	EnlTot
statesmen	RspTot
algeria	Nation
entertainment	WlbTot
pen	COM
slum	WlbTot
zone	Region
lift	TranLw
pta	EnlTot
nude	Quality
emotional	WlbTot
ran	Source
door	TimeSpc
release	TranLw
retain	IAV
ascribe	EnlTot
tramp	Need
analyze	EnlTot
probationary	Source
amazing	IndAdj
platform	PowTot
mood	WlbTot
fire	TrnLoss
inventory	WltTot
collar	IAV
rain	DAV
nucleus	Space
per	Source
verb	FormLw
little	DIM
argue	EnlTot
superficiality	Eval@
recruitment	Means
fright	WlbTot
consolidate	IAV
reorganization	PowTot
aspect	EnlTot
erase	DAV
conduct	IAV
component	MeansLw
improper	IndAdj
amiable	IPadj
deter	PowTot
take	DAV
remarkably	SureLw
pursuit	EndsLw
prevent	PowTot
exhaust	IAV
glow	IAV
craze	Vice
autonomy	PowTot
behave	IAV
congressmen	PowTot
kitchen	SklTot
dozen	CARD
nourish	TrnGain
bane	Vice
liar	RcTot
fill	EndsLw
manchester	Name
bitterness	WlbTot
vacillate	If
unscrupulous	IndAdj
she	Female
muster	TranLw
print	DAV
store	TimeSpc
utilization	Work
meritorious	IndAdj
grain	WltTot
section	Space
southeast	TimeSpc
disappoint	Anomie
sanitation	WlbTot
oval	TimeSpc
silence	Quality
wrinkle	Eval@
sinful	IndAdj
coverage	FormLw
impress	EndsLw
assessment	EnlTot
sterling	WltTot
involuntary	IndAdj
populous	HU
inefficiency	Stay
shipment	Means
foolishness	Vice
long	TimeSpc
decease	IAV
principal	SureLw
necessity	EndsLw
sugar	Food
neat	EVAL
oat	Food
nimble	IndAdj
driven	IAV
dishonest	IPadj
imperfect	IndAdj
slept	WlbTot
ticket	COM
romance	SocRel
freak	Quality
presumably	EnlTot
same	Rel
laugh	FormLw
change	TranLw
signal	FormLw
saw	EnlTot
dizzy	IndAdj
build	SklTot
committee	PowTot
audacious	IndAdj
left	TimeSpc
motion	Travel
ball	SklTot
choice	EndsLw
congo	Nation
tail	TranLw
simplify	IAV
attic	BldgPt
satellite	PowTot
supernatural	RcTot
test	If
enjoyment	WlbTot
forgave	RcTot
drive	EndsLw
hunt	EnlTot
layer	TimeSpc
volatility	Vary
progressive	EndsLw
cancer	WlbTot
expressive	EnlTot
operation	WlbTot
sake	ComForm
accompany	DAV
senile	IndAdj
tense	IndAdj
recruit	TrnGain
horn	If
literalness	Doctrin
posterity	Time@
embarrassment	WlbTot
looseness	Quality
mechanic	SklTot
overthrown	PowTot
often	TimeSpc
toward	TimeSpc
ambassador	PowTot
roundabout	IndAdj
amendment	FormLw
convert	IAV
stage	TranLw
chicken	ANI
otherwise	Know
dusty	Quality
puny	NegAff
fallen	Source
scale	IAV
behaviour	Source
undefined	If
detrimental	NegAff
lessen	TranLw
tamper	IAV
vow	RspTot
organ	Source
felt	Source
stationary	Stay
pride	RspTot
bomb	PowTot
ridicule	FormLw
veranda	BldgPt
precision	SklTot
mastery	Know
affable	IPadj
kindle	TranLw
intelligent	EnlTot
ameliorate	TrnGain
base	IAV
console	IAV
brutal	Source
america	Name
ostracize	IAV
privacy	RspTot
van	Vehicle
dissention	Vice
venom	Vice
dagger	NegAff
taxpayer	WltTot
mister	RspTot
shop	WltTot
excessive	NegAff
anonymous	FormLw
corrective	Source
abortive	PowTot
admission	FormLw
dictate	IAV
student	EnlTot
sustain	TranLw
parlour	Source
hustler	ComForm
supply	TrnGain
earnest	RcTot
slice	IAV
access	Means
flower	IAV
educator	EnlTot
afterward	TimeSpc
european	PowTot
into	TimeSpc
persist	EndsLw
cope	WlbTot
intelligible	FormLw
equivalent	Know
port	WltTot
rip	TranLw
spotless	IndAdj
hemisphere	ArenaLw
rent	FormLw
birthday	RspTot
beg	RspTot
fuck	IAV
study	EnlTot
college	EnlTot
alert	Arousal
inward	TimeSpc
reader	EnlTot
exuberant	IndAdj
celebrity	HU
workmanship	Quality
alternative	EndsLw
beauteous	IndAdj
jealous	AffTot
grip	IAV
scorch	IAV
approximate	If
pigment	Tool
precaution	MeansLw
piety	Ought
cramp	IAV
ohio	Name
harshest	Source
defer	IAV
hinge	IAV
refinement	Virtue
backer	PowTot
consideration	EnlTot
liability	WltTot
temporary	TimeSpc
chivalrous	IPadj
convinced	FormLw
severe	NegAff
light	TranLw
oath	FormLw
measure	TranLw
rash	IndAdj
bond	FormLw
cent	WltTot
insecurity	EndsLw
relevance	EndsLw
penal	PowTot
advent	Begin
onset	Begin
liberty	PowTot
completion	Finish
joker	HU
kitten	Source
oppress	PowTot
waver	IAV
fact	SureLw
pretence	RcTot
shortsighted	IndAdj
six	CARD
wake	TranLw
unprecedented	SureLw
statistics	EnlTot
hurl	PowTot
wealth	WltTot
circular	Space
equality	RspTot
army	PowTot
promise	FormLw
shutter	BldgPt
wyoming	Source
plenty	Quan
contribution	TrnGain
fragile	IndAdj
philippines	Nation
fifty	CARD
coup	PowTot
exceed	IAV
rationalize	EnlTot
pasture	Land
utah	Source
ideal	EndsLw
unify	PowTot
point	FormLw
offer	FormLw
manageable	IndAdj
shipbuilding	Source
whereas	Know
handful	Quan
abuse	RspTot
january	TimeSpc
chaos	Anomie
kept	Source
ration	IAV
marrow	BodyPt
east	TimeSpc
freedom	PowTot
jew	RcTot
humble	RspTot
excommunication	Legal
lurk	IAV
inveterate	Source
injustice	RcTot
undecided	If
question	FormLw
configuration	Space
hereby	Causal
shoddy	IndAdj
arbiter	Solve
close	TrnLoss
size	IAV
rest	WlbTot
spring	TimeSpc
swamp	Aquatic
rat	ComForm
bearer	HU
shock	WlbTot
actual	SureLw
page	IAV
infallibility	Know
cumulative	Quan
impotency	MeansLw
advisory	FormLw
addict	Need
fervently	PosAff
construe	EnlTot
swim	DAV
grab	TranLw
census	Ritual
anything	Ovrst
tiny	DIM
off	Space
ascend	PowTot
outrun	IAV
removal	PowTot
joyful	WlbTot
congressman	PowTot
deplorable	RcTot
pretentious	IndAdj
controller	WltTot
wall	WltTot
late	TimeSpc
ate	WlbTot
enable	SklTot
sorrow	AffTot
inaugurate	IAV
either	If
ardent	PosAff
blissful	IndAdj
longevity	Stay
hilarious	IndAdj
routine	MeansLw
alter	TranLw
gradual	Persist
stylish	IndAdj
trifle	Quan
interfere	PowTot
adjunct	Rel
homogeneous	Quality
invest	WltTot
insufficient	EndsLw
everyday	Time@
enrich	TrnGain
disavow	NegAff
computer	EnlTot
fretful	IndAdj
farewell	FormLw
walk	TranLw
rabbit	ANI
emancipation	PowTot
postponement	TimeSpc
mansion	Social
withdrawn	WlbTot
autocrat	HU
pain	WlbTot
hillside	Land
saline	WlbTot
gloomy	Anomie
slaughter	IAV
insolent	IndAdj
hanger	HU
generous	WltTot
assertion	Know
verdict	FormLw
trail	IAV
behavior	SocRel
patriot	HU
horror	NegAff
examine	EnlTot
recourse	Source
wrong	NegAff
mystical	EnlTot
adroitly	Virtue
cooperative	PowTot
louisiana	Source
pit	PowTot
delicate	Quality
mystery	EnlTot
straw	NatObj
vile	NegAff
dependence	PowTot
transaction	SocRel
undergraduate	EnlTot
breast	WlbTot
fair	RcTot
exclusive	RspTot
caress	FormLw
satisfactory	EndsLw
heat	WlbTot
standard	Quality
unity	PowTot
fraudulent	IndAdj
uncle	AffTot
opportune	IndAdj
mint	WltTot
gamble	If
throughout	Space
settler	PowTot
design	EndsLw
revenge	SocRel
sympathy	AffTot
descriptive	EnlTot
refugee	PtLw
awoke	Source
farm	WltTot
dependent	PtLw
surplus	WltTot
federate	PowTot
doubtful	If
sweet	EVAL
shirt	Tool
harden	Source
indomitable	IndAdj
distribute	TranLw
pilot	PowTot
offshore	TimeSpc
nourishment	Food
responsive	Arousal
temporarily	IndAdj
vindictive	NegAff
assure	SureLw
mockery	ComForm
strangle	DAV
successful	EndsLw
trust	PosAff
illustrious	IndAdj
detachment	Ovrst
adaptability	Vary
gain	EndsLw
pump	IAV
rejection	NotLw
infamous	RcTot
semester	EnlTot
emotion	WlbTot
overall	Know
underground	Source
pope	RcTot
thunder	Sky
regulation	PowTot
brown	COLOR
combination	TrnGain
impassable	Source
govern	PowTot
mixture	Quality
incorrect	SklTot
such	Quan
congratulate	RspTot
again	TimeSpc
nut	Food
respectable	RspTot
expectation	EndsLw
groin	WlbTot
respect	EnlTot
inevitable	SureLw
religion	RcTot
sincerity	RcTot
millionth	Ovrst
hanker	Source
stumble	TrnLoss
undergo	TranLw
reestablish	IAV
plan	MeansLw
disclaim	IAV
limp	IndAdj
exclusiveness	RspTot
character	PtLw
brutish	IndAdj
express	EnlTot
threaten	PowTot
improvement	TrnGain
election	PowTot
productive	EndsLw
undertaken	EndsLw
glisten	IAV
likely	If
medium	DIM
found	TranLw
renown	RspTot
hag	HU
something	Quan
swoon	SV
anarchist	HU
hung	TranLw
ascendant	PowTot
repulse	PowTot
eastern	TimeSpc
float	DAV
independence	PowTot
spokesman	EnlTot
suffrage	PowTot
dismay	NegAff
imprison	IAV
unnatural	NegAff
assertive	PowTot
merciless	IPadj
versatile	IndAdj
brass	WltTot
officer	PowTot
smoke	DAV
watchful	If
retail	WltTot
education	EnlTot
repetition	FREQ
status	RspTot
export	WltTot
indicative	IndAdj
comparable	EnlTot
elevate	TrnGain
any	Quan
partner	PowTot
whack	IAV
resort	WlbTot
mountain	Land
viable	Virtue
orchestra	SklTot
gifted	SklTot
park	DAV
together	PowTot
effect	EndsLw
few	Quan
backward	TimeSpc
eighteenth	ORD
hope	EndsLw
judicious	SklTot
automobile	WltTot
coyote	ANI
supervise	PowTot
nickname	FormLw
catch	If
community	PowTot
disgrace	RspTot
interpret	EnlTot
then	Time@
central	TimeSpc
intrusion	SocRel
council	PowTot
lure	IAV
sheer	Quality
narrative	FormLw
corrode	IAV
mutter	DAV
purchase	WltTot
smart	TranLw
menial	IndAdj
curtsey	DAV
traditional	RspTot
servitude	SocRel
dominant	PowTot
forthcoming	TimeSpc
dash	IAV
cereal	Food
mail	EnlTot
shell	PowTot
gun	PowTot
globe	ArenaLw
bourgeois	PowTot
appoint	PowTot
television	EnlTot
slack	IAV
dancer	SklTot
accurate	EnlTot
lust	Need
purity	Virtue
diplomacy	PowTot
exclaim	Source
unemployed	WltTot
in	Space
stream	TranLw
destroy	PowTot
ghost	HU
missouri	Source
congregation	RcTot
editor	EnlTot
knock	PowTot
join	TranLw
pacify	PowTot
communicate	FormLw
advisor	EnlTot
complement	RspTot
locate	EnlTot
suburban	Region
historical	EnlTot
evaluation	EnlTot
environmental	Region
clamorous	IndAdj
seeker	RcTot
paraguay	Nation
tantrum	Exert
passion	AffTot
bunk	Tool
infect	IAV
eccentric	IndAdj
go	EndsLw
tonight	TimeSpc
exam	EnlTot
sprain	IAV
far	TimeSpc
vindication	RcTot
forum	FormLw
recklessness	Vice
graceful	SklTot
solidity	Quality
refrigerator	Tool
ambiguity	If
encroach	IAV
annals	EnlTot
wherein	TimeSpc
virginia	Name
portuguese	Nation
awkward	NegAff
lit	TranLw
croak	IAV
safe	MeansLw
invitation	FormLw
exact	IAV
neglect	NegAff
nineteenth	Source
pointless	IndAdj
remind	EnlTot
reflection	EnlTot
detection	EnlTot
regiment	PowTot
pretext	Source
culmination	Rel
dispose	PowTot
hour	TimeSpc
without	Source
were	Source
seethe	SV
whisky	Food
drug	Food
magician	PtLw
palatial	IndAdj
cash	WltTot
gave	Source
shallow	TimeSpc
whenever	TimeSpc
endowment	WltTot
counteract	PowTot
heaven	RcTot
staple	Food
thickness	Space
god	RcTot
victorious	IndAdj
collide	IAV
much	Quan
registration	FormLw
snake	ANI
lane	Route
capricious	IPadj
positiveness	Doctrin
acquaint	EnlTot
realization	EnlTot
haiti	Nation
iran	Nation
topmost	IndAdj
feminine	SklTot
valid	EnlTot
focal	Space
adaptation	Vary
plead	PowTot
sedentary	IndAdj
condescending	IPadj
loud	FormLw
slanderer	RspTot
obedient	IPadj
merit	RspTot
memorable	IndAdj
marginal	Space
sparkle	IAV
overturn	IAV
scatter	IAV
stop	TranLw
accede	PowTot
wept	WlbTot
down	Space
chum	HU
subsequent	Time@
being	PtLw
compass	Tool
esplanade	Route
ginger	Food
liquidation	TrnLoss
inconsiderable	Source
bean	Food
cast	TranLw
politeness	Ought
ceiling	BldgPt
throne	RspTot
placid	Arousal
amply	Increas
interest	FormLw
liquid	Tool
humidity	NatrPro
authentic	Ovrst
heart	AffTot
incidental	Means
seminary	RcTot
arbitrator	PowTot
imperial	PowTot
prolong	TranLw
exertion	Work
cut	TrnLoss
decide	SureLw
vale	Land
brainy	IndAdj
ugly	NegAff
administrative	PowTot
manufacture	WltTot
candidate	PowTot
family	AffTot
boarder	PtLw
depression	WlbTot
pie	Food
cherish	EndsLw
communal	IPadj
german	Nation
insight	EnlTot
field	ArenaLw
worse	NegAff
balloon	Tool
sanguine	PosAff
vindicate	RcTot
fondness	EMOT
quantitative	Quan
crisis	EndsLw
approve	RspTot
communism	PowTot
adore	SV
coach	IAV
break	TrnLoss
shiver	IAV
partisanship	PowTot
preparatory	IndAdj
league	TimeSpc
confess	RcTot
guilt	RcTot
unto	Space
wary	If
another	Quan
expedient	Means
frustration	TrnLoss
near	TimeSpc
vast	TimeSpc
dictionary	EnlTot
speak	FormLw
forehead	BodyPt
submit	TranLw
rental	WltTot
paris	PowTot
agreement	FormLw
membership	HU
continue	EndsLw
grind	DAV
novelist	SklTot
decisive	SureLw
ceremonial	IndAdj
socialism	PowTot
expell	PowTot
recent	EnlTot
sever	NegAff
lead	FormLw
ego	WlbTot
embark	Source
ski	DAV
unsure	If
utopia	EndsLw
heroin	Food
whip	PowTot
rob	RcTot
grant	TrnGain
promote	TrnGain
bewilder	EnlTot
nominal	Know
local	TimeSpc
difference	ABS
stride	TranLw
grove	Land
devastate	TrnLoss
sneer	IAV
benign	Virtue
boast	IAV
unimpeachable	IndAdj
syria	Nation
include	TranLw
forgiven	RcTot
cabinet	PowTot
lunatic	Eval@
francisco	Name
complete	SureLw
compensation	TrnGain
fool	RspTot
paternal	AffTot
hungary	Nation
bill	WltTot
bower	Social
ship	TranLw
judge	TranLw
crusader	Travel
bunch	Quan
body	WlbTot
supreme	PowTot
theory	EnlTot
cessation	PowTot
oversight	Perceiv
with	Source
fourth	Source
municipal	PowTot
measurable	IndAdj
infer	IAV
draw	PowTot
accuse	RcTot
talker	HU
killer	HU
attitude	EnlTot
factor	EnlTot
flung	IAV
brake	Tool
malady	NatrPro
those	Source
insufficiency	Decreas
transition	ABS
lamb	Source
etc	Ovrst
profit	WltTot
wherever	TimeSpc
residential	Region
november	TimeSpc
masterful	IndAdj
affirm	TrnGain
duct	Tool
tray	Tool
recall	IAV
gusto	Power
traffic	Travel
fixate	Source
uneven	Negate
sway	Source
commissioner	PowTot
jamaica	Nation
curl	DAV
occupy	PowTot
envious	EndsLw
coat	DAV
aggravation	PowTot
already	Time@
ratify	PowTot
britain	Nation
chatter	FormLw
destructive	PowTot
ratification	PowTot
noun	FormLw
merrily	EMOT
fertilizer	WltTot
temple	RcTot
for	Source
illinois	Source
misbehavior	RcTot
bark	DAV
formation	Means
brag	IAV
construction	SklTot
stupid	SklTot
dictatorship	PowTot
agree	FormLw
evolve	EndsLw
condition	If
disunity	PowTot
smack	IAV
plain	EVAL
create	EndsLw
unmitigated	SureLw
unreasonable	EnlTot
afloat	IndAdj
waste	IAV
mean	NotLw
affect	IAV
masculine	HU
elaboration	Increas
over	TimeSpc
worthless	NegAff
contingent	If
deadly	WlbTot
retard	TrnLoss
twelve	CARD
succession	TimeSpc
enemy	PowTot
privy	IndAdj
suspension	TranLw
succeed	TimeSpc
sketchy	IndAdj
nonetheless	Know
taught	EnlTot
unlawful	IndAdj
urge	TranLw
famous	RspTot
allowable	IPadj
affliction	TrnLoss
tooth	BodyPt
travel	TranLw
adviser	EnlTot
across	TimeSpc
mali	Nation
usefulness	Virtue
panic	Anomie
luxurious	IndAdj
abide	IAV
tire	NegAff
defame	IAV
function	AffTot
prepare	TranLw
misguide	EnlTot
fund	WltTot
accost	IAV
intensity	Perceiv
unselfish	IPadj
agreeable	FormLw
daughter	AffTot
surpass	TrnGain
uniform	Source
dreadful	WlbTot
nullification	Negate
expanse	Space
bum	Econ@
township	Region
preside	PowTot
eagle	ANI
spot	TimeSpc
ruinous	IndAdj
albania	Nation
fatal	WlbTot
providence	RcTot
worrier	HU
foggy	Quality
shiny	IndAdj
sundown	TimeSpc
scamper	IAV
asunder	IndAdj
expedite	Source
sister	AffTot
heavy	Quality
fond	AffTot
vagrant	Travel
aim	EndsLw
revere	IAV
inflexible	Source
decision	EnlTot
warrant	TranLw
funeral	Ritual
persuade	PowTot
give	FormLw
import	WltTot
industry	WltTot
encourage	TrnGain
daze	Undrst
cartel	WltTot
survivor	Stay
desertion	Travel
worst	NegAff
author	EnlTot
inept	SklTot
feud	SocRel
bogus	IndAdj
overworked	IndAdj
appertain	Source
speculation	EnlTot
coffee	WltTot
see	EnlTot
the	Source
opera	FormLw
information	FormLw
restrictive	PowTot
old	TimeSpc
interview	FormLw
rid	IAV
guideline	EnlTot
wanderer	HU
imperceptible	EnlTot
rapport	ComForm
desolation	Vice
bush	NatObj
ailment	Pain
buzzard	ANI
tangle	Rel
criminal	RcTot
savvy	Know
smell	DAV
chairman	PowTot
lion	ANI
three	CARD
has	SV
decree	PowTot
roof	DAV
awareness	EnlTot
exultation	Eval@
early	TimeSpc
uneasy	If
viper	ANI
bombardment	Hostile
southerner	PtLw
realize	TrnGain
hazard	EndsLw
investigate	EnlTot
spectator	PtLw
weariness	Try
await	RspTot
urgency	EndsLw
york	Source
puppy	ANI
tender	AffTot
nerve	BodyPt
outset	Begin
maiden	PtLw
daddy	AffTot
germ	WlbTot
ambitious	PowTot
ethical	RcTot
careless	Vice
impact	NatrPro
wed	AffTot
exaggeration	Eval@
cathedral	RcTot
inquiry	FormLw
orthodox	Relig
original	TimeSpc
fancy	EVAL
learner	EnlTot
stiffly	Quality
worn	DAV
designer	SklTot
keyboard	Tool
birthplace	RspTot
czechoslovakia	Nation
egypt	Nation
confusion	If
diurnal	TimeSpc
reach	TranLw
arrive	DAV
controversy	FormLw
prophet	EnlTot
someone	PtLw
rally	IAV
capitalism	PowTot
lost	TranLw
loneliness	AffTot
had	SV
overseer	PowTot
motor	Tool
bury	DAV
behead	Exert
estrangement	PowTot
judicial	PowTot
existence	TimeSpc
juicy	Quality
maneuver	IAV
hamburger	Food
realisation	Source
contempt	SocRel
puzzle	EnlTot
plantation	WltTot
invulnerable	IndAdj
burdensome	IPadj
bloom	IAV
flavour	Source
clutter	Vice
friendship	AffTot
parliamentary	PowTot
underwent	IAV
premises	Source
his	MALE
payment	WltTot
secede	IAV
dispel	PowTot
fiber	Tool
bravery	RcTot
tolerable	IPadj
rational	SklTot
seed	NatObj
trumpet	Tool
propose	FormLw
synthetic	Quality
vacation	WlbTot
railway	Route
constant	EndsLw
intimate	AffTot
vested	PowTot
latent	Know
delegate	PowTot
garage	Social
certificate	ComnObj
contributor	WltTot
wrought	IndAdj
plot	FormLw
meaningless	EnlTot
cripple	IAV
curiosity	EnlTot
addition	If
instrumental	SureLw
naturalization	PowTot
evident	SureLw
cotton	WltTot
exercise	IAV
preoccupy	EnlTot
bought	WltTot
momentum	Increas
economize	IAV
every	Quan
settle	PosAff
contingency	If
grandeur	Ritual
passionate	AffTot
doctrine	PowTot
derby	Ritual
reflex	NatrPro
book	EnlTot
adjustment	Virtue
congenial	AffTot
justification	RcTot
tangible	EnlTot
stare	TranLw
general	TimeSpc
spectacular	EVAL
spiritual	RcTot
boston	Name
during	TimeSpc
clean	RcTot
speedy	Time@
comparison	EnlTot
discourage	Anomie
kuwait	Nation
commodity	WltTot
valuable	EndsLw
deliver	TrnGain
powder	Tool
treaty	PowTot
vein	BodyPt
supra	Source
jacket	Tool
attach	DAV
senator	PowTot
forerunner	HU
accolade	ComForm
litigation	PowTot
power	PowTot
but	Undrst
bliss	EMOT
fiasco	Fail
research	EnlTot
antipathy	Undrst
scornful	IPadj
rug	Source
recur	Source
causal	EnlTot
buy	WltTot
magnificence	Ovrst
revision	TranLw
bolt	IAV
trot	IAV
dishearten	Anomie
dinner	WlbTot
announce	FormLw
perform	SklTot
ditch	IAV
classify	EnlTot
shed	TranLw
frown	NegAff
imitate	Source
pod	NatObj
compare	EnlTot
scarcely	Quan
dwelling	Social
undergone	IAV
absent	IndAdj
nazi	PowTot
perplex	EnlTot
modernity	Time@
savage	IndAdj
triumphant	PosAff
cavalry	PowTot
invention	SklTot
theatre	Social
unprepared	Negate
master	PowTot
peace	PowTot
debate	FormLw
consequence	EndsLw
amateur	SklTot
slam	NegAff
inhabit	TranLw
auditor	WltTot
exile	IAV
unavoidable	SureLw
resolute	PowTot
spinster	HU
ashamed	RspTot
superiority	PowTot
conceive	EnlTot
resignation	Fail
presumption	EnlTot
instrument	MeansLw
weak	PowTot
collective	PowTot
demoralize	IAV
shoot	TranLw
triumph	PosAff
luxemberg	Nation
opinionated	IndAdj
disclose	FormLw
labour	Source
wholesome	IndAdj
summit	PLACE
ambush	PowTot
revel	IAV
sanity	Know
disobedient	IPadj
knife	TrnLoss
nix	IAV
around	Space
scare	NegAff
respectful	IndAdj
woken	Source
inaccessible	IPadj
revise	TranLw
janitor	RspTot
cite	FormLw
hurrah	Intrj
estate	WltTot
phenomenon	Know
scramble	IAV
select	PowTot
standardize	IAV
abnormal	NegAff
laborer	WltTot
contemplation	EnlTot
identification	EnlTot
visit	TranLw
anywhere	TimeSpc
face	FormLw
coincidence	Time@
emissary	PowTot
continuity	Rel
enactment	PowTot
repugnant	RspTot
specification	Know
europe	PowTot
knit	Source
fugitive	Travel
riches	Object
introduction	TranLw
farmer	WltTot
wander	TranLw
persia	Nation
pan	TranLw
rouge	COLOR
through	Space
because	Causal
immaturity	RspTot
emasculate	WlbTot
golden	WltTot
prussia	Nation
frigid	IndAdj
overwhelming	IndAdj
aimless	Anomie
risky	IndAdj
taxation	WltTot
deplete	MeansLw
trend	EndsLw
circumstance	ArenaLw
cursory	IndAdj
lonely	AffTot
upper	TimeSpc
fulfill	TrnGain
modest	RspTot
scary	IndAdj
admirer	HU
interviewer	EnlTot
endanger	EndsLw
uninterrupted	Source
lame	IndAdj
conversion	Vary
race	ArenaLw
washington	PowTot
orient	TimeSpc
intoxicate	IAV
lest	Source
florida	Source
beard	BodyPt
presence	Know
feasible	IndAdj
curt	FormLw
discriminate	IAV
heretofore	TimeSpc
pinnacle	Complet
quality	SklTot
shall	TranLw
artist	SklTot
perhaps	If
subservience	SocRel
sect	RcTot
capability	MeansLw
animal	ANI
unquestioned	Negate
coast	IAV
space	TimeSpc
ache	SV
clear	TimeSpc
knew	EnlTot
thirst	NatrPro
productivity	WltTot
comely	IndAdj
colonial	PowTot
china	Nation
intervene	PowTot
untruth	IndAdj
disavowal	FormLw
ghetto	PowTot
overbearing	IndAdj
amaze	IAV
clumsy	IndAdj
menace	PowTot
step	PowTot
inspection	EnlTot
reds	PowTot
likable	IPadj
quitter	Fail
road	If
divine	RcTot
sketch	COM
buckle	IAV
fallout	NatrPro
filial	IPadj
punctual	IndAdj
manner	MeansLw
robust	IndAdj
secure	EndsLw
amenable	IndAdj
inestimable	SureLw
bruise	Pain
spirit	WlbTot
total	TranLw
candle	Tool
greatest	Source
integrity	RcTot
merchant	WltTot
hypocrisy	ComForm
spray	DAV
hospitality	AffTot
monopoly	PowTot
paltry	IndAdj
cell	BldgPt
unarm	IndAdj
undertook	EndsLw
respective	Know
disingenuous	IPadj
corner	TimeSpc
engagement	FormLw
legislature	PowTot
subjection	Submit
loan	WltTot
implement	EndsLw
atlas	COM
elect	PowTot
realm	PowTot
trespass	IAV
bake	SklTot
source	MeansLw
slump	WlbTot
goodwill	RcTot
stereotype	Know
maternal	AffTot
mess	NegAff
statuesque	IndAdj
luckily	EndsLw
outburst	ComForm
job	SklTot
lag	IAV
bloodthirsty	IPadj
ecumenical	RcTot
calculation	EnlTot
disappear	DAV
pamper	IAV
elementary	Know
camp	WlbTot
glorious	PosAff
despot	PowTot
plentiful	Quan
drastic	SureLw
plate	Tool
shield	IAV
tore	Source
sunshine	Sky
unnoticed	IndAdj
meddle	IAV
clique	AffTot
mouse	ANI
reclaim	IAV
item	Know
impurity	Eval@
consign	IAV
redress	TrnGain
noiseless	IndAdj
beneficial	PosAff
tantamount	Source
submission	PowTot
remorse	EMOT
viscosity	Quality
anxious	WlbTot
themselves	Source
inconsistency	Ovrst
satire	FormLw
refer	TranLw
utterance	ComForm
upturn	Quality
dim	IAV
degrade	RspTot
constancy	Positiv
restore	PowTot
relevancy	Eval@
tedious	NegAff
fluent	IndAdj
grievance	WlbTot
recurrence	Source
thailand	Nation
artificial	Vice
omit	TranLw
ensure	TrnGain
otter	ANI
terminate	TimeSpc
deride	IAV
distinguished	IndAdj
afraid	NotLw
silk	WltTot
civilization	ArenaLw
mutual	HU
voluntary	PowTot
characterize	EnlTot
reassurance	FormLw
craziness	Vice
afghanistan	Nation
sophisticated	EVAL
dual	Quan
pot	Tool
ensemble	HU
perception	EnlTot
explorer	EnlTot
psychology	EnlTot
hunch	EnlTot
relish	IAV
advisable	PosAff
ambition	PowTot
lake	Aquatic
consternation	Solve
contention	PowTot
april	TimeSpc
incontestable	SureLw
dark	Quality
alas	Intrj
impunity	Legal
negotiate	PowTot
reply	FormLw
seize	PowTot
hasten	TranLw
majority	PowTot
wild	Quality
teamster	HU
partake	TranLw
sediment	NatObj
four	CARD
verify	EnlTot
turkey	Nation
regrettable	IndAdj
kansas	Source
yea	Intrj
loveless	AffTot
fee	WlbTot
eligible	PowTot
empirical	Know
discernible	EnlTot
slid	DAV
dispute	FormLw
sit	DAV
bus	Vehicle
contest	PowTot
credulous	IndAdj
youthful	WlbTot
blockade	PowTot
blur	IAV
bundle	Quan
corps	PtLw
telegram	EnlTot
hoard	IAV
bound	SureLw
combustion	NatrPro
eloquent	FormLw
course	SureLw
desolate	Vice
bishop	RcTot
magnitude	Quan
rebellion	PowTot
sell	WltTot
greece	Nation
simplicity	Ovrst
obey	PowTot
bloc	PowTot
cream	IAV
taste	SV
moderation	PowTot
sober	IndAdj
junior	EnlTot
letter	FormLw
gladness	EMOT
nay	Intrj
regain	TrnGain
discern	IAV
energize	IAV
till	TimeSpc
influence	PowTot
calmness	Undrst
literal	FormLw
attain	EndsLw
madness	Eval@
honest	SureLw
nine	CARD
malaysia	Nation
charity	ECON
chosen	EndsLw
remainder	Quan
nihilistic	Anomie
aptitude	Virtue
home	AffTot
victory	PowTot
wives	AffTot
consent	FormLw
fog	Sky
fruit	Food
decadence	Need
unprovoked	PowTot
tide	Aquatic
cafe	Social
bubble	IAV
fatalistic	IndAdj
million	WltTot
proven	Source
investor	WltTot
food	WlbTot
subsistence	NatrPro
glossy	IndAdj
persistence	EndsLw
disappearance	Perceiv
negotiation	PowTot
deficiency	Vice
center	TimeSpc
glare	Perceiv
career	SklTot
northerly	TimeSpc
signature	COM
conclude	TimeSpc
norm	RcTot
jump	DAV
conductor	SklTot
historian	EnlTot
stability	MeansLw
censorship	RcTot
dip	DAV
angelic	IndAdj
procurement	Means
pleasure	PosAff
remote	Space
affiliate	PowTot
leap	TranLw
accustom	IAV
commendation	Ritual
arch	DAV
breakfast	Food
deception	EnlTot
percentage	Quan
unjustified	RcTot
purr	IAV
surround	TimeSpc
cloth	Tool
valor	RspTot
sunburn	WlbTot
operative	Means
and	Source
coerce	IAV
subversion	PowTot
destination	Goal
secrecy	ComForm
crook	HU
count	EnlTot
steadfastness	Persist
anomaly	Rel
adulterate	IAV
club	PowTot
gunmen	PowTot
continent	PowTot
debut	Ritual
rigid	IndAdj
panama	Nation
statistical	Doctrin
alledge	PowTot
apprehension	WlbTot
breath	WlbTot
execution	SocRel
form	EnlTot
thyroid	WlbTot
decadent	IndAdj
pin	TranLw
congress	PtLw
supplier	WltTot
ranger	PowTot
depraved	IndAdj
tube	Source
scope	Space
root	MeansLw
thrive	SV
mature	RspTot
sanitary	IndAdj
ripple	Quality
sag	IAV
ask	EnlTot
confederacy	PowTot
odd	EVAL
realise	Source
problem	PowTot
aspire	EndsLw
backbone	Power
affluent	IndAdj
adroit	IndAdj
pair	Quan
vacuum	DAV
sequence	TimeSpc
indemnity	WltTot
adventurous	PosAff
correction	Positiv
renew	TranLw
slave	SklTot
criticise	Source
workmen	SklTot
abstain	TranLw
immortal	IndAdj
inhumane	IndAdj
newspaper	EnlTot
munition	PowTot
operator	EnlTot
perfection	Complet
irrational	EnlTot
restoration	PowTot
characteristic	EnlTot
unanimity	PowTot
chose	EndsLw
thereupon	TimeSpc
voluntarily	PowTot
chemical	Tool
false	RcTot
easiest	Source
american	Name
sung	DAV
gentlemen	RspTot
lemon	Food
sandy	Quality
drowsy	IndAdj
embellish	IAV
pretty	Quan
weekly	TimeSpc
spoke	EnlTot
agility	Virtue
deny	NotLw
uncivil	IndAdj
neither	NotLw
capitol	PowTot
evidently	MeansLw
anticipate	SV
proportion	Quan
contemptuous	NegAff
inconceivable	SureLw
summon	PowTot
single	IAV
imperative	EndsLw
mist	Sky
promulgate	PowTot
silver	WltTot
symphonic	FormLw
nobleman	HU
dexterity	Vary
guinea	Nation
aloof	IPadj
workshop	Social
fiction	FormLw
depth	Space
political	PowTot
downtown	Region
acquire	TrnGain
subordinate	PowTot
disconcerted	Undrst
nominate	PowTot
ax	IAV
indices	Know
forbidden	FormLw
responsibility	RcTot
appreciate	RspTot
hegemony	PowTot
plural	Source
violence	WlbTot
antagonist	HU
top	IAV
seat	PowTot
overjoyed	IndAdj
ridge	Land
championship	Power
injury	WlbTot
adhere	RcTot
sneak	IAV
sentiment	AffTot
thereon	Source
cultivation	Rel
simulate	IAV
coincide	IAV
account	FormLw
indispensability	Virtue
blast	PowTot
could	PowTot
unnecessary	Negate
vehement	IndAdj
my	Self
parent	AffTot
portion	Quan
rot	DAV
righteousness	RcTot
massachusetts	Name
weary	WlbTot
unemployment	WltTot
indignant	RcTot
incomplete	Negate
endure	WlbTot
pry	IAV
agency	PowTot
belgium	Nation
definite	SureLw
save	TranLw
restrict	PowTot
statesman	RspTot
expression	FormLw
slow	DAV
dread	WlbTot
visible	Perceiv
funny	EVAL
eighteen	CARD
prudence	Ought
headache	Vice
divert	IAV
scholastic	EnlTot
extra	Quan
guerrilla	PowTot
instance	If
juice	Food
signify	EnlTot
adherent	IndAdj
thriving	WlbTot
chivalry	Doctrin
campus	EnlTot
package	ComnObj
alertness	Think
maine	Source
siege	PowTot
coachman	HU
avarice	Vice
second	TimeSpc
admonish	IAV
cult	RcTot
overcome	PowTot
prayer	FormLw
thorny	IndAdj
encouragement	PowTot
monitor	EnlTot
esteem	Eval@
coolness	EMOT
level	MeansLw
candid	EnlTot
fifteen	CARD
elder	RspTot
liberia	Nation
accord	PosAff
produce	EndsLw
demand	FormLw
dive	DAV
pour	DAV
cruelty	NegAff
vulgar	RspTot
infirmity	WlbTot
skeptical	If
romanticize	IAV
due	FormLw
itself	Source
classification	EnlTot
ruthless	PowTot
indies	PowTot
arizona	Source
shark	ANI
dungeon	PLACE
musician	SklTot
favourable	Source
flatter	IAV
advance	TimeSpc
spreader	Tool
wallow	SV
void	Need
stratum	Space
glue	Tool
alteration	TranLw
wrongful	IndAdj
feet	TimeSpc
indifference	AffTot
shaker	RcTot
energy	WltTot
sixteenth	Source
india	Nation
carriage	Vehicle
practice	EndsLw
foresee	EnlTot
run	DAV
cordial	AffTot
revoke	IAV
inflate	WltTot
prettily	Virtue
prompt	IAV
strive	EndsLw
grin	FormLw
let	SureLw
chuckle	PosAff
resourceful	IndAdj
series	Time@
skillful	SklTot
once	TimeSpc
summary	FormLw
contract	PowTot
universe	ArenaLw
consistent	EndsLw
greek	Nation
australian	Nation
suspect	EnlTot
assassinate	IAV
meal	WlbTot
discontent	WlbTot
infinite	SureLw
studio	Social
meditation	Think
rhine	PowTot
altercation	Exert
active	EndsLw
sought	EndsLw
constrain	PowTot
fearful	WlbTot
correct	PosAff
goal	EndsLw
storm	PowTot
vice	RcTot
farsighted	IndAdj
west	TimeSpc
anecdote	FormLw
colorado	Source
bent	Quality
come	TimeSpc
frivolous	IndAdj
stigma	RspTot
speedily	IndAdj
elite	PowTot
flavor	IAV
ascent	Rise
excerpt	FormLw
constituent	PowTot
divinity	RcTot
heroic	RspTot
planer	SklTot
lab	EnlTot
aversion	Negate
logic	EnlTot
collection	Quan
company	WltTot
plod	IAV
figure	FormLw
impervious	IndAdj
double	FormLw
sixty	CARD
witchcraft	Means
quantity	Quan
seek	EndsLw
ammunition	PowTot
combine	TrnGain
walnut	Food
reconsider	EnlTot
graduation	Finish
pest	SocRel
unison	PowTot
subserviency	PowTot
grandchildren	AffTot
holly	NatObj
trunk	Tool
upheld	PowTot
burn	WlbTot
copyright	WltTot
out	TimeSpc
inate	Source
know	EnlTot
cooky	Food
stifle	TrnLoss
therein	TimeSpc
salesmen	WltTot
tourist	WltTot
understandable	EnlTot
enrollment	FormLw
rib	BodyPt
combat	PowTot
probation	Legal
twitch	IAV
consultation	EnlTot
exemplary	PosAff
movement	TranLw
terrorism	WlbTot
applaud	DAV
rival	PowTot
substantial	Quan
possessor	PowTot
shut	TranLw
sedition	PowTot
recommendation	FormLw
gorgeous	IndAdj
recompense	Exch
rifle	Tool
bargain	IAV
ecstatic	IndAdj
hinder	TrnLoss
separate	TimeSpc
distort	EnlTot
entire	SureLw
friction	NatrPro
scotland	Nation
argument	FormLw
scandalous	RcTot
compel	PowTot
intrude	IAV
ponder	EnlTot
dramatic	FormLw
potency	Quan
illegality	Eval@
idol	Goal
day	TimeSpc
filth	Vice
beep	FormLw
property	WltTot
telling	RcTot
sputter	IAV
downhearted	IndAdj
business	EndsLw
indispensable	EndsLw
prize	RspTot
century	TimeSpc
tribunal	PowTot
parasite	Fetch
despicable	IndAdj
which	Source
zen	ABS
nutrition	WlbTot
ownership	WltTot
headlight	Tool
feint	IAV
phrase	FormLw
electrical	WltTot
housekeeper	SklTot
scheme	EndsLw
scientist	EnlTot
credible	IndAdj
disperse	DAV
assail	RspTot
anyhow	Undrst
harmony	PowTot
jury	PowTot
western	TimeSpc
solace	Think
tobacco	Food
chin	BodyPt
pistol	PowTot
disagree	PowTot
wire	TranLw
cause	EnlTot
passive	PowTot
differ	PowTot
exasperate	WlbTot
evoke	Source
mishap	Fail
diabolic	IndAdj
minor	Quan
former	TimeSpc
recognition	EnlTot
midnight	TimeSpc
unequivocal	SureLw
adhesive	IndAdj
boot	IAV
shelf	Tool
monotonous	IndAdj
wipe	TranLw
hypothesis	EnlTot
unlikelihood	Negate
wrist	Source
fickle	IndAdj
sculpture	TranLw
august	TimeSpc
premature	TimeSpc
fist	BodyPt
moralistic	IndAdj
designate	PowTot
crisp	Quality
whether	If
negative	NotLw
patronize	IAV
dictator	PowTot
soreness	EMOT
battleship	PowTot
ear	If
team	PowTot
studious	IndAdj
legislation	PowTot
both	Quan
smile	FormLw
perfectionist	HU
discontinue	TrnLoss
spit	DAV
wife	AffTot
plunge	DAV
did	IAV
fabricate	IAV
cancellation	Finish
suffer	TranLw
repair	WlbTot
crush	PowTot
missile	PowTot
moscow	PowTot
philosopher	EnlTot
admit	FormLw
struggle	PowTot
super	Virtue
explore	EnlTot
incumbent	RcTot
honey	Source
potent	PowTot
nasty	IndAdj
desperate	Anomie
sage	IndAdj
inequitable	RcTot
feather	SklTot
crest	Space
therefore	Causal
superficial	Undrst
christ	RcTot
daylight	TimeSpc
perishable	WlbTot
meteor	Sky
impartiality	Know
scrape	IAV
insurrection	PowTot
moderate	IAV
lawyer	SklTot
undertake	EndsLw
wit	PosAff
masses	PowDoct
may	TimeSpc
serene	EMOT
mahogany	NatObj
aluminum	Tool
occurrence	Vary
accordance	PowTot
curtain	Tool
glass	Tool
excel	IAV
static	IndAdj
denote	EnlTot
participation	PowTot
statutory	PowTot
multiplication	TranLw
originate	IAV
vivacious	IndAdj
virtue	RcTot
mistook	EnlTot
splendid	SklTot
tying	Source
timidity	Vice
accountable	IndAdj
pacific	PowTot
cheery	EMOT
freeze	Source
convene	IAV
notoriety	Ovrst
smuggle	IAV
livelihood	WlbTot
conceivable	EnlTot
homeward	WlbTot
love	AffTot
obstinate	IndAdj
miraculous	IndAdj
music	FormLw
representation	FormLw
wilderness	Land
cardinal	Source
wave	DAV
ministerial	PowTot
empire	PowTot
descendant	PtLw
immature	RspTot
procrastination	Stay
critic	EnlTot
educate	EnlTot
wrath	Hostile
torturous	IndAdj
tendency	If
tell	EnlTot
driver	SklTot
gaiety	WlbTot
positive	SureLw
zinc	Tool
folder	ArenaLw
two	CARD
ignorance	EnlTot
photograph	TranLw
wear	TranLw
chilly	Quality
subsist	WlbTot
perpetuate	IAV
readily	Ovrst
merriment	EMOT
rebuild	TrnGain
sergeant	PowTot
yelp	IAV
invasion	PowTot
support	PowTot
disproportionate	IndAdj
healthy	WlbTot
furnish	IAV
traveller	Source
elasticity	Quality
trigger	Tool
built	Source
inundated	IndAdj
odor	Quality
listener	HU
fidelity	PowTot
distribution	TranLw
father	AffTot
talent	SklTot
erroneous	IndAdj
bloody	WlbTot
meter	Space
wound	WlbTot
crave	SV
instructor	EnlTot
feeler	PowTot
reinforce	PowTot
among	TimeSpc
fibre	Source
data	EnlTot
whose	Source
boastful	IndAdj
dreamer	PtLw
thereto	TimeSpc
hop	DAV
thrash	IAV
planet	Sky
illness	WlbTot
stupor	Think
meticulous	IndAdj
remember	EnlTot
magnificent	PosAff
school	FormLw
event	If
mingle	AffTot
cringe	IAV
ramble	IAV
range	TimeSpc
easterner	HU
example	EnlTot
steam	TranLw
invaluable	PosAff
rupture	DAV
ignoble	IndAdj
five	CARD
crouch	DAV
herd	WltTot
low	DIM
damp	Quality
professional	SklTot
cannon	PowTot
hall	BldgPt
squat	DAV
hen	ANI
tough	Quality
capacity	MeansLw
tempt	IAV
companion	AffTot
husband	AffTot
gymnast	HU
patron	WltTot
crumple	IAV
analytical	EnlTot
subvert	PowTot
confession	FormLw
protocol	PowTot
autonomous	IPadj
party	AffTot
celebrate	RspTot
presume	EnlTot
some	Quan
hear	EnlTot
unfavorable	NegAff
paint	SklTot
slot	Space
concession	PowTot
befit	PosAff
physics	EnlTot
trouble	NegAff
rebellious	IPadj
incapable	MeansLw
defective	EVAL
darken	IAV
africa	PowTot
roughness	IndAdj
needle	IAV
embrace	FormLw
bachelor	AffTot
multiple	Quan
continuation	Source
overcame	PowTot
complaint	FormLw
transportation	WltTot
pass	DAV
insecure	EndsLw
apparatus	SklTot
antagonistic	NegAff
intruder	HU
motley	Quality
militia	PowTot
mound	Land
alternate	IAV
institutional	PowTot
untiring	Source
soon	TimeSpc
enlightenment	EnlTot
reconsideration	EnlTot
suspicion	Undrst
stammer	DAV
handy	Virtue
inequality	RspTot
bankrupt	IndAdj
subsidize	IAV
clamor	ComForm
flaw	Fail
derision	Vice
obligation	RcTot
trade	WltTot
drum	Tool
unless	If
deduct	IAV
stomach	TranLw
adulteration	Vice
legend	FormLw
sincere	RcTot
sacred	RcTot
credo	RcTot
breach	RcTot
glen	Land
stipulation	FormLw
timer	Tool
spontaneous	Virtue
mold	TranLw
astound	SV
cupid	HU
caught	TrnGain
preventive	PowTot
ratio	Quan
compartment	Space
conspire	IAV
burden	IAV
dolly	PtLw
mineral	WltTot
lean	PowTot
who	PtLw
follow	TimeSpc
unequal	PowTot
compromise	PowTot
overwhelm	PowTot
attractive	EndsLw
heroism	RcTot
jet	Vehicle
england	Nation
milk	WlbTot
waterway	Source
curb	PowTot
hotel	Social
keel	Tool
impure	IndAdj
predicament	Eval@
prosperous	WltTot
recreation	Pleasur
recover	TrnGain
intimacy	AffTot
particle	NatObj
heartily	Strong
richness	Econ@
stagecoach	Vehicle
throat	WlbTot
belligerent	PowTot
fragrant	IndAdj
inane	IndAdj
commission	PowTot
destruct	TrnLoss
compression	NatrPro
picture	COM
almost	If
fortification	PowTot
subscribe	IAV
viet	Nation
thursday	TimeSpc
insolence	SocRel
grenade	PowTot
shrug	DAV
baffle	EnlTot
involvement	Arousal
architecture	SklTot
flu	WlbTot
inside	TimeSpc
apathy	Undrst
speculative	EnlTot
beauty	SklTot
middle	TimeSpc
widow	AffTot
lull	Negate
campaign	PowTot
unsoundness	Negate
prohibit	PowTot
unruly	IndAdj
street	Route
badger	ANI
persecute	IAV
infection	Hostile
cat	ANI
connect	IAV
falsehood	Quality
gloat	IAV
result	EndsLw
interference	PowTot
seventh	Source
infrequent	TimeSpc
organic	NatrPro
rehabilitate	TranLw
feature	IAV
therefrom	TimeSpc
unlimited	SureLw
neutrality	PowTot
pessimism	Think
sand	Land
danish	Nation
somewhat	If
detest	NegAff
akin	Know
distracting	IndAdj
exalt	IAV
modify	TranLw
verbal	FormLw
cheek	BodyPt
estrange	PowTot
scared	NegAff
indirect	Negate
thinker	EnlTot
enchant	IAV
generosity	Econ@
indiana	Source
educational	EnlTot
also	Quan
description	FormLw
vantage	Perceiv
reprehensible	IPadj
empty	DAV
valley	Land
nightmare	Fail
setter	ANI
mediate	PowTot
villager	PowTot
intensify	IAV
togetherness	COLL
recommend	PowTot
revisit	EnlTot
pennsylvania	Name
smooth	IAV
manager	SklTot
dig	EnlTot
implore	IAV
intransigent	PowTot
tractor	Vehicle
destine	EndsLw
algiers	Nation
colonel	RspTot
rely	PowTot
sensitivity	ABS
ally	PowTot
shrewd	Virtue
dealer	WltTot
interval	TimeSpc
likewise	Know
recess	TimeSpc
anniversary	TIME
influx	Source
radiance	Quality
thank	FormLw
apart	TimeSpc
appease	PowTot
worsen	IAV
corporation	WltTot
messenger	EnlTot
please	PosAff
taken	Source
dishonor	RcTot
inordinate	NegAff
note	EnlTot
quick	TimeSpc
administer	PowTot
overflow	IAV
lyric	FormLw
suggestion	FormLw
explain	EnlTot
vastness	Ovrst
pull	IAV
drop	DAV
cook	SklTot
hardy	WlbTot
impetus	Causal
always	SureLw
am	TimeSpc
dominance	Power
horizontal	POS
inflation	WltTot
lose	TrnLoss
forgot	EnlTot
vitality	WlbTot
claim	FormLw
foolish	SklTot
frontier	Land
murderous	IPadj
philosophic	EnlTot
mercy	AffTot
begin	EndsLw
publication	EnlTot
black	WlbTot
invent	SklTot
wicked	RcTot
control	PowTot
deduce	IAV
rebel	PowTot
elastic	Quality
advancement	EndsLw
glean	IAV
torrent	Fall
mindful	EnlTot
razor	Tool
privilege	RspTot
they	Source
perseverance	RcTot
shine	DAV
lifelong	IndAdj
prince	PowTot
organise	Source
helplessness	Vice
reap	TrnGain
rite	RcTot
understand	EnlTot
argentine	Nation
gymnastic	Exprsv
australia	Nation
self	PtLw
