Term	Category
jolly	Positiv
indulgence	Positiv
attachment	Positiv
humor	Positiv
savor	Positiv
jubilee	Positiv
revel	Positiv
merriment	Positiv
resolve	Positiv
enthusiastic	Positiv
uplift	Positiv
confident	Positiv
amour	Positiv
secure	Positiv
balmy	Positiv
joy	Positiv
fondness	Positiv
restful	Positiv
happy	Positiv
value	Positiv
attraction	Positiv
merrily	Positiv
hilarious	Positiv
willing	Positiv
grateful	Positiv
poetic	Exprsv
happiness	Positiv
dote	Positiv
comfort	Positiv
enchantment	Positiv
fantasy	Positiv
lust	Positiv
sweetness	Positiv
devote	Positiv
satisfy	Positiv
assure	Positiv
mirth	Positiv
romance	Positiv
gratification	Positiv
rosy	Positiv
comfortable	Positiv
jubilant	Positiv
ecstatic	Positiv
pleased	Positiv
pleasant	Positiv
repose	Positiv
gaiety	Positiv
intimacy	Positiv
decoration	Positiv
amuse	Positiv
decorative	Positiv
contentment	Positiv
triumphant	Positiv
recreation	Positiv
excited	Positiv
delightful	Positiv
game	Exprsv
excitement	Positiv
appeal	Legal
carefree	Positiv
optimistic	Positiv
delight	Positiv
cheerful	Positiv
therapeutic	Positiv
willingness	Positiv
romantic	Positiv
purr	Positiv
cuddle	Positiv
determine	EMOT
whimsical	Relig
hot	Negativ
gratify	Positiv
sublime	Positiv
smitten	Positiv
gladden	Positiv
amusement	Positiv
pride	Positiv
appreciation	Positiv
relief	Positiv
harmonious	Positiv
blithe	Positiv
relaxation	Positiv
joyful	Positiv
overjoyed	Positiv
zeal	Pleasur
relish	Positiv
enjoy	Positiv
relieve	Positiv
cheery	Positiv
fascinate	Arousal
rest	Pleasur
pleasurable	Positiv
tranquility	Positiv
content	Positiv
sanguine	Positiv
confidence	Positiv
gaily	Positiv
satisfaction	Positiv
pleasure	Positiv
cozy	Positiv
tingle	Positiv
ease	Positiv
rejoice	Positiv
thrill	Positiv
elate	Positiv
endear	Positiv
gay	Positiv
decorate	Positiv
glee	Positiv
dreamland	Positiv
comic	Positiv
love	Positiv
proud	Positiv
enthusiasm	Positiv
admiration	Positiv
flirt	Positiv
apocalypse	Positiv
tenderness	Positiv
admire	Positiv
please	Positiv
recline	Positiv
jest	Positiv
appreciative	Positiv
comestible	Positiv
celebrate	Positiv
spirit	Relig
glad	Positiv
bliss	Positiv
exhilaration	Positiv
humorous	Positiv
blissful	Positiv
adore	Positiv
warmhearted	Positiv
cupid	Positiv
respite	Positiv
eager	Positiv
refuge	Positiv
adulation	Positiv
calm	Positiv
earnest	Positiv
merry	Positiv
ecstasy	Positiv
gladness	Positiv
excite	Positiv
upbeat	Positiv
comical	Positiv
calmness	Positiv
fun	Exprsv
sting	Negativ
depression	Econ@
frustration	Negativ
weep	Negativ
frighten	Negativ
numb	Negativ
indignation	Negativ
cramp	Negativ
resentful	Negativ
scrape	Negativ
sore	Negativ
dejected	Negativ
mourn	Negativ
thoughtless	Negativ
disagreeable	Negativ
disturb	Negativ
tired	Negativ
woeful	Negativ
dismay	EMOT
frantic	Negativ
bruise	Negativ
distress	Negativ
soreness	Negativ
miserable	Negativ
disappointment	Negativ
anxious	Negativ
mourner	Negativ
wary	Negativ
stink	Negativ
depress	Negativ
irritation	Negativ
moan	Negativ
despise	Negativ
torturous	Negativ
sprain	Negativ
edge	Negativ
sorrowful	Negativ
irk	Negativ
concern	Econ@
wretch	Negativ
wince	Negativ
ill	Negativ
dissatisfied	Negativ
melancholy	Negativ
grieve	Negativ
forlorn	Negativ
unnerve	Negativ
misery	Negativ
outrage	Negativ
scared	Negativ
scald	Negativ
unassured	Pain
fury	Negativ
dishonor	Negativ
malice	Negativ
downhearted	Negativ
lone	Negativ
nervousness	Negativ
wretchedness	Negativ
agonize	Negativ
tense	Negativ
grizzly	Negativ
dissolution	Negativ
woe	Negativ
malicious	Negativ
anxiety	Negativ
ashamed	Negativ
disillusion	EMOT
grief	Negativ
hurt	Negativ
rue	Negativ
hopeless	Negativ
shrill	Negativ
hard	Negativ
chafe	Negativ
ache	Negativ
plight	Negativ
press	Econ@
lonesome	Negativ
commiseration	Negativ
dizzy	Negativ
fearful	Negativ
irritable	Negativ
lament	Negativ
discontent	Negativ
unwilling	Negativ
regrettable	Negativ
scary	Negativ
whimper	Negativ
hostility	Negativ
apologetic	Pain
shriek	Negativ
uneasiness	Negativ
fed	Negativ
pain	Negativ
wallow	Negativ
panic	Negativ
yelp	Negativ
wail	Negativ
dread	Negativ
dissatisfaction	Negativ
dishearten	Negativ
disappoint	Negativ
clatter	Negativ
lonely	Negativ
smart	Positiv
scare	Negativ
exasperation	Negativ
clamor	Negativ
famine	Negativ
weary	EMOT
grievance	Negativ
doldrums	Negativ
anxiousness	Negativ
hysterical	Negativ
loneliness	Negativ
nervous	Negativ
shame	Negativ
gash	Negativ
strain	Negativ
exhaustion	Negativ
discomfort	Negativ
beset	Negativ
intolerable	Negativ
unhappy	Negativ
cripple	Negativ
sullen	Negativ
tolerable	Negativ
unbearable	Negativ
somber	Negativ
agony	Negativ
bitterness	Negativ
downfall	Negativ
remorse	Negativ
terror	Negativ
terrify	Negativ
unwillingness	Negativ
anguish	Negativ
sad	Negativ
glum	Negativ
shock	Negativ
pout	Negativ
worry	Negativ
grudge	Negativ
frustrate	Negativ
horror	Negativ
shameful	Negativ
commit	Negativ
frightful	Negativ
hostile	Negativ
uncomfortable	Negativ
unhappiness	Negativ
bitter	Negativ
upset	Negativ
hung	Negativ
downcast	Negativ
despair	Negativ
regret	Negativ
tension	Negativ
fearsome	Negativ
afraid	Negativ
burdensome	Negativ
hysteria	Negativ
oppressive	Negativ
cringe	Negativ
sorry	Negativ
tire	Negativ
trouble	Negativ
stricken	Negativ
hurtful	Negativ
writhe	Negativ
sob	Negativ
uneasy	Negativ
wind	Pain
unsettling	Negativ
bloodshed	Negativ
suffer	Negativ
perturb	Negativ
mortify	Negativ
desperation	Negativ
destitute	Econ@
lamentable	Negativ
tragedy	Negativ
injure	Negativ
blue	Econ@
apprehension	Negativ
humiliation	Negativ
fatigue	Negativ
stress	Negativ
discourage	Negativ
gloom	Negativ
restlessness	Negativ
resentment	Negativ
clamorous	Negativ
gloomy	Negativ
shiver	Negativ
unspeakable	Negativ
displeasure	Negativ
fear	Negativ
desperate	Negativ
sorrow	Negativ
ail	Negativ
touchy	Negativ
distrustful	Negativ
disgust	Negativ
estranged	Negativ
disconcerted	Negativ
conflict	Negativ
neurotic	Negativ
apprehensive	Negativ
guilt	Negativ
ailment	Negativ
brood	Negativ
sadness	Negativ
yearn	Negativ
prejudicial	Negativ
opinionated	Negativ
optional	Positiv
positiveness	Positiv
voluntary	Positiv
fervor	Positiv
covet	Negativ
preference	Positiv
crave	Negativ
qualm	Negativ
resolute	Positiv
apathy	Negativ
fiery	Positiv
vigilant	Positiv
optimism	Positiv
rigid	Negativ
vehement	Negativ
apathetic	Negativ
involuntary	Negativ
superstition	Negativ
esteem	Positiv
eagerness	Positiv
antipathy	Negativ
unmoved	Negativ
entrust	Positiv
superstitious	Negativ
obstinate	Negativ
exuberance	Positiv
fervent	Positiv
resolved	Positiv
selfishness	Negativ
earnestness	Positiv
gratitude	Positiv
exuberant	Positiv
aloof	Negativ
objection	Negativ
outcry	Negativ
willful	Positiv
unfeeling	Negativ
vigilance	Positiv
cranky	Negativ
giddy	Positiv
repress	Negativ
reluctant	Negativ
astonish	Arousal
sensitivity	Positiv
furious	Negativ
sensitive	Positiv
responsive	Positiv
bristle	Negativ
seriousness	Positiv
attitude	EMOT
suspicion	Negativ
true	Positiv
awe	EMOT
abhor	Negativ
belligerent	Negativ
spite	Negativ
involvement	Arousal
sympathy	Positiv
pamper	Positiv
mellow	Positiv
serene	Positiv
appreciate	Positiv
anticipate	Arousal
distrust	Arousal
impatience	Negativ
berserk	Negativ
placid	Arousal
hatred	Negativ
touch	Exprsv
feel	EMOT
antagonism	Negativ
passive	Arousal
question	Arousal
modesty	Positiv
notoriety	Positiv
inspirational	Positiv
impartiality	Positiv
try	Legal
wonder	Positiv
affectionate	Positiv
meditation	Positiv
preoccupy	Arousal
sentiment	EMOT
appetite	Arousal
acrimonious	Negativ
spend	Econ@
impartial	Positiv
bite	Negativ
sympathize	Positiv
determination	Arousal
passion	EMOT
homage	Positiv
cross	Relig
wide	Arousal
move	Arousal
sentimental	EMOT
disposition	Arousal
sympathetic	Positiv
like	Positiv
adamant	Positiv
emotion	EMOT
indifference	Negativ
trust	Econ@
care	Positiv
passionate	Positiv
temper	Negativ
emotional	EMOT
genial	Positiv
sense	Positiv
morale	Positiv
bashful	Negativ
angry	Negativ
watch	Arousal
zest	Positiv
motivate	Positiv
assertion	Positiv
dislike	Negativ
fond	Positiv
overwhelm	Arousal
alert	Arousal
antagonize	Negativ
understand	Positiv
expectation	Arousal
pity	EMOT
respect	Positiv
hate	Negativ
beloved	Positiv
inspiration	Positiv
mood	EMOT
anger	Negativ
peaceable	Positiv
readiness	Arousal
anticipation	Arousal
intimate	Positiv
dispose	Negativ
favor	Positiv
antagonistic	Negativ
restless	Negativ
impulse	Arousal
mad	Negativ
serious	Positiv
regard	Positiv
quandary	Negativ
unexpected	Arousal
ready	Arousal
devotion	Relig
challenge	Negativ
prejudice	Negativ
confound	Negativ
amaze	Arousal
acrimony	Negativ
rage	Negativ
shy	EMOT
mind	Negativ
suit	Legal
annoyance	Negativ
affection	Positiv
heart	Positiv
restraint	Arousal
puzzlement	Negativ
surprise	Virtue
heat	Arousal
suspense	Arousal
suspicious	Negativ
preoccupation	Arousal
will	Legal
insistent	Positiv
aversion	Negativ
swoon	Positiv
coolness	Negativ
interest	Econ@
cocky	Negativ
enjoyment	Positiv
fickle	Negativ
desire	Negativ
certain	Virtue
solemn	Relig
indifferent	Negativ
callous	Negativ
collect	Virtue
religious	Relig
scornful	Negativ
controversy	Negativ
desolation	Negativ
fierce	Negativ
crazy	Negativ
doubt	Negativ
alienation	Negativ
courage	Positiv
creative	Exprsv
haughty	Negativ
hopeful	Positiv
mix	Negativ
admirer	Positiv
long	EMOT
spiteful	Negativ
moody	Negativ
warmth	Positiv
faith	Relig
sick	Negativ
compassionate	Positiv
enrage	Negativ
wish	EMOT
motivated	Positiv
compassion	Positiv
gall	Negativ
detest	Negativ
ferocious	Negativ
curious	EMOT
shameless	Negativ
heartless	Negativ
aggressive	Negativ
curiosity	EMOT
contempt	Negativ
friendly	Positiv
almighty	Positiv
scorn	Negativ
desirable	Positiv
courtly	Polit@
elegant	Positiv
magnificence	Positiv
authenticity	Positiv
clean	Positiv
honorable	Positiv
talented	Positiv
equitable	Positiv
grace	Relig
enjoyable	Positiv
reputable	Positiv
note	Virtue
adaptive	Positiv
handy	Positiv
adaptability	Positiv
bonny	Positiv
just	Legal
majesty	Positiv
expert	Positiv
vigor	Virtue
spare	Positiv
treat	Positiv
consistency	Positiv
fortitude	Positiv
invincible	Positiv
overture	Virtue
profound	Positiv
innocent	Legal
allure	Positiv
amiable	Positiv
scrupulous	Positiv
plausible	Virtue
toleration	Positiv
fine	Econ@
must	Virtue
productive	Econ@
resourcefulness	Positiv
decent	Positiv
reform	Polit@
cooperative	Econ@
earth	Virtue
benevolent	Econ@
pretty	Positiv
modernization	Virtue
fellowship	Positiv
sacred	Relig
skill	Positiv
practical	Positiv
fit	Positiv
stately	Positiv
ingenious	Positiv
potentiality	Virtue
significant	Positiv
victorious	Positiv
humanitarian	Polit@
tolerant	Positiv
magnificent	Positiv
coordination	Positiv
mighty	Positiv
lead	Positiv
undaunted	Virtue
foresight	Positiv
appropriate	Positiv
lucky	Positiv
accurate	Positiv
luckily	Positiv
heavenly	Relig
adjustment	Positiv
imaginative	Exprsv
likable	Positiv
trustworthy	Positiv
influential	Virtue
taste	Exprsv
fruitful	Positiv
loyal	Polit@
versatile	Positiv
intellectual	Academ
establish	Positiv
flair	Positiv
angelic	Relig
stylish	Positiv
brotherhood	Positiv
spotless	Positiv
athletic	Exprsv
cautious	Virtue
precise	Positiv
best	Positiv
lawful	Legal
accustom	Virtue
amiability	Positiv
round	Positiv
economical	Econ@
tolerance	Positiv
tremendous	Positiv
satisfactorily	Positiv
progressive	Positiv
decency	Positiv
dear	Positiv
benign	Positiv
standard	Virtue
foremost	Positiv
exceptional	Virtue
vigorous	Virtue
adornment	Positiv
evaluation	Virtue
amicable	Positiv
providence	Relig
thoughtful	Positiv
precious	Econ@
valiant	Positiv
resplendent	Positiv
ethical	Positiv
suave	Positiv
adequate	Positiv
board	Academ
darling	Positiv
valid	Positiv
divine	Relig
supreme	Legal
innocence	Positiv
surplus	Econ@
affable	Positiv
luck	Positiv
generous	Positiv
cherish	Positiv
persistent	Virtue
workable	Positiv
free	Positiv
constructive	Positiv
rich	Econ@
benevolence	Econ@
splendor	Positiv
supply	Econ@
freedom	Polit@
viable	Positiv
start	Virtue
road	Polit@
faithfulness	Positiv
influence	Virtue
chaste	Positiv
keen	Positiv
adaptation	Positiv
health	Positiv
astute	Positiv
pinnacle	Positiv
sound	Positiv
sufficient	Positiv
ambition	Virtue
accuracy	Positiv
eligible	Virtue
courageous	Positiv
noble	Positiv
paramount	Positiv
moral	Positiv
untouched	Positiv
generosity	Econ@
meaningful	Positiv
godliness	Positiv
normal	Positiv
justification	Positiv
objective	Positiv
wonderful	Positiv
apt	Positiv
beacon	Positiv
thorough	Positiv
luxury	Econ@
cleanliness	Positiv
worth	Econ@
compensation	Positiv
dynamic	Positiv
strength	Virtue
clever	Positiv
accommodation	Positiv
miraculous	Relig
manly	Positiv
baby	Econ@
help	Negativ
fancy	Positiv
better	Positiv
protection	Positiv
train	Positiv
aid	Positiv
chivalrous	Positiv
intelligence	Academ
adroitly	Positiv
reliability	Positiv
understandable	Positiv
talent	Positiv
vital	Virtue
affability	Positiv
infallible	Positiv
considerate	Positiv
accurateness	Positiv
improve	Positiv
sophisticated	Positiv
advantageous	Positiv
intellect	Academ
priceless	Econ@
beauty	Positiv
adjust	Positiv
ability	Positiv
funny	Positiv
integrity	Positiv
correct	Positiv
casual	Positiv
fortune	Econ@
handsome	Positiv
straight	Positiv
sanitary	Positiv
hit	Negativ
simplicity	Positiv
legitimate	Legal
outstanding	Positiv
splendid	Positiv
faithful	Relig
duty	Negativ
precision	Positiv
liberal	Academ
rather	Virtue
essential	Positiv
autonomy	Virtue
glorious	Positiv
conventional	Virtue
virtuous	Positiv
common	Econ@
profitable	Econ@
quaint	Positiv
bold	Virtue
perfect	Positiv
own	Econ@
power	Polit@
famous	Positiv
deep	Virtue
accessible	Positiv
soundness	Positiv
assistance	Positiv
sincere	Positiv
unbroken	Positiv
quality	Positiv
capable	Positiv
well	Positiv
selective	Positiv
solidarity	Virtue
basic	Positiv
impressive	Positiv
collaboration	Positiv
immaculate	Positiv
undoubtedly	Positiv
excellence	Positiv
infallibility	Positiv
promptly	Positiv
preferably	Virtue
supernatural	Relig
completeness	Positiv
satisfactory	Positiv
opportune	Positiv
progress	Positiv
skillful	Positiv
courteous	Positiv
compatible	Positiv
hospitable	Positiv
respectful	Positiv
charm	Positiv
altruistic	Positiv
shrewd	Positiv
buy	Econ@
careful	Positiv
safety	Positiv
sensational	Positiv
eminent	Positiv
ideal	Positiv
honest	Positiv
humble	Positiv
wit	Virtue
chivalry	Positiv
simplify	Positiv
emancipation	Polit@
enlighten	Positiv
courtesy	Positiv
democracy	Polit@
boldness	Positiv
encourage	Positiv
premium	Positiv
reasonable	Positiv
available	Virtue
virtue	Positiv
resourceful	Positiv
agile	Positiv
harmony	Positiv
discipline	Virtue
popular	Positiv
harmless	Positiv
invite	Positiv
character	Exprsv
dedicate	Positiv
admirable	Positiv
adult	Positiv
demand	Vice
merit	Positiv
neat	Positiv
learn	Academ
versatility	Positiv
kind	Positiv
treasure	Econ@
right	Legal
suitable	Positiv
dedication	Positiv
respectable	Positiv
suffrage	Polit@
strenuous	Virtue
prominent	Positiv
favorable	Positiv
salvation	Relig
goodness	Positiv
sensible	Positiv
divinity	Relig
sumptuous	Positiv
rare	Virtue
usefulness	Positiv
wealthy	Econ@
leisure	Exprsv
unity	Positiv
mint	Positiv
diligent	Positiv
doubtless	Positiv
advance	Positiv
fluent	Positiv
friendship	Positiv
honor	Positiv
lovely	Positiv
majestic	Positiv
remarkably	Positiv
heroism	Positiv
support	Positiv
peaceful	Positiv
fortunate	Positiv
gracious	Positiv
tact	Positiv
super	Positiv
palatial	Positiv
spontaneous	Virtue
frank	Positiv
share	Positiv
sweet	Positiv
authentic	Positiv
positive	Positiv
due	Econ@
approve	Positiv
culture	Positiv
acclamation	Positiv
usable	Positiv
experience	Positiv
civility	Positiv
equality	Polit@
consistent	Positiv
commendable	Positiv
terrific	Positiv
wisdom	Academ
forgiveness	Positiv
competitive	Negativ
pure	Positiv
attractive	Positiv
purify	Positiv
marvelous	Positiv
venerable	Positiv
safe	Positiv
gentle	Positiv
advantage	Positiv
daring	Positiv
prestige	Positiv
productivity	Econ@
superiority	Positiv
punctual	Positiv
independent	Polit@
pertinent	Positiv
noteworthy	Virtue
sport	Exprsv
important	Positiv
prudent	Positiv
open	Positiv
heroic	Positiv
eloquent	Exprsv
favorite	Positiv
rescue	Positiv
security	Econ@
truth	Positiv
credit	Academ
merciful	Positiv
bless	Relig
gallantry	Positiv
perfection	Positiv
promise	Positiv
perseverance	Positiv
humility	Positiv
elegance	Positiv
practicable	Positiv
sincerity	Positiv
control	Virtue
spectacular	Positiv
palatable	Positiv
sociable	Positiv
service	Milit
organize	Positiv
indisputable	Virtue
regal	Positiv
obligation	Virtue
dignity	Positiv
cherub	Positiv
wholesome	Positiv
reward	Econ@
beneficent	Positiv
charity	Econ@
congenial	Positiv
validity	Positiv
vitality	Positiv
affinity	Positiv
opportunity	Positiv
polite	Positiv
real	Econ@
holy	Relig
cultivate	Positiv
flawless	Positiv
assist	Positiv
shrewdness	Positiv
nice	Positiv
popularity	Positiv
authoritative	Legal
thoughtfulness	Positiv
unimpeachable	Polit@
availability	Positiv
truthful	Positiv
miracle	Relig
unselfish	Positiv
charitable	Econ@
competence	Positiv
propitious	Positiv
aptitude	Positiv
chosen	Positiv
moderate	Positiv
helpful	Positiv
superior	Positiv
composure	Positiv
refinement	Positiv
spiritual	Relig
trustworthiness	Positiv
good	Positiv
healthful	Positiv
cover	Virtue
exact	Positiv
behalf	Positiv
enchant	Positiv
fantastic	Positiv
conviction	Positiv
encouragement	Positiv
absolute	Virtue
discretion	Positiv
acclaim	Positiv
alertness	Positiv
proper	Positiv
purity	Positiv
reliable	Positiv
valor	Positiv
genuine	Positiv
stability	Positiv
glory	Positiv
contemplation	Virtue
adept	Positiv
fairness	Positiv
bravery	Positiv
efficiency	Positiv
hardy	Positiv
gallant	Positiv
conformity	Virtue
discreet	Positiv
beneficial	Positiv
graceful	Positiv
useful	Positiv
blameless	Legal
cooperation	Positiv
convenient	Virtue
conscience	Positiv
principle	Legal
mature	Positiv
supremacy	Virtue
vivacious	Positiv
busy	Virtue
loyalty	Polit@
grown	Virtue
patience	Positiv
adroit	Positiv
allegiance	Positiv
purification	Positiv
privilege	Virtue
responsible	Positiv
benefactor	Econ@
effectiveness	Positiv
competent	Positiv
agility	Positiv
subtle	Positiv
fair	Exprsv
educated	Academ
able	Positiv
lot	Virtue
take	Virtue
prove	Virtue
acceptable	Positiv
efficient	Positiv
kindness	Positiv
gifted	Positiv
invulnerable	Positiv
remarkable	Positiv
prosperity	Positiv
brave	Positiv
special	Positiv
legitimacy	Legal
smash	Negativ
renown	Positiv
cordial	Positiv
effective	Positiv
peace	Positiv
decisive	Virtue
amenable	Positiv
veritable	Positiv
valuable	Econ@
convenience	Virtue
extraordinary	Positiv
sane	Positiv
efficacy	Positiv
alight	Positiv
prime	Positiv
actual	Positiv
adaptable	Positiv
loveliness	Positiv
justifiably	Positiv
angel	Relig
modest	Positiv
exclusive	Virtue
healthy	Positiv
easy	Positiv
condition	Virtue
inspire	Positiv
conscientious	Positiv
salutary	Positiv
prettily	Positiv
greatness	Positiv
wise	Academ
politeness	Positiv
accolade	Positiv
improvement	Positiv
ball	Exprsv
return	Econ@
mercy	Positiv
use	Econ@
worthy	Positiv
actuality	Positiv
meritorious	Econ@
prudence	Positiv
adorable	Positiv
significance	Positiv
typical	Virtue
grand	Positiv
distinguish	Positiv
intelligent	Positiv
solace	Positiv
sure	Virtue
prompt	Positiv
pious	Relig
excellent	Positiv
commitment	Positiv
superlative	Positiv
ambitious	Virtue
cut	Negativ
dependable	Positiv
cute	Positiv
guidance	Virtue
qualify	Positiv
rational	Academ
arrest	Legal
stupendous	Positiv
capital	Econ@
patient	Positiv
indispensability	Positiv
potential	Virtue
might	Polit@
refine	Positiv
responsibility	Positiv
powerful	Polit@
undoubted	Positiv
beat	Exprsv
injury	Negativ
avaricious	Negativ
detachment	Negativ
discord	Negativ
cruelty	Negativ
negative	Negativ
threat	Negativ
danger	Negativ
risky	Negativ
amiss	Negativ
ungrateful	Negativ
repulsive	Negativ
stigma	Negativ
complication	Negativ
deficient	Negativ
disdain	Negativ
clumsy	Negativ
grave	Relig
childish	Negativ
penalty	Legal
impersonal	Negativ
detrimental	Negativ
force	Milit
dire	Negativ
disadvantageous	Negativ
confusion	Negativ
abuse	Negativ
careless	Negativ
immoral	Negativ
lack	Negativ
indecisive	Vice
delinquency	Negativ
sloth	Negativ
redundant	Negativ
unable	Vice
prohibitive	Negativ
contamination	Negativ
brute	Negativ
deplorable	Negativ
instability	Negativ
pest	Negativ
superficial	Negativ
peculiar	Negativ
agitation	Negativ
capricious	Negativ
bondage	Negativ
delirium	Negativ
dubious	Negativ
madman	Negativ
difficulty	Negativ
serve	Econ@
stale	Negativ
wrong	Negativ
ruinous	Negativ
double	Negativ
instable	Negativ
impulsive	Negativ
disastrous	Negativ
radical	Polit@
hapless	Negativ
detestable	Negativ
naive	Negativ
envy	Negativ
front	Negativ
treacherous	Negativ
unfavorable	Negativ
condemnation	Negativ
adultery	Negativ
defect	Negativ
oversight	Negativ
pollution	Negativ
primitive	Vice
impatient	Negativ
symptom	Negativ
fanatical	Negativ
audacity	Negativ
unclean	Negativ
hack	Negativ
outrageous	Negativ
menace	Negativ
load	Negativ
domination	Negativ
untrustworthy	Negativ
rejection	Negativ
ordeal	Negativ
audacious	Negativ
desertion	Negativ
slug	Negativ
dominant	Vice
crisis	Negativ
superficiality	Negativ
reprehensible	Negativ
impurity	Negativ
divorce	Legal
questionable	Negativ
boastful	Negativ
unreliable	Negativ
unrest	Negativ
futility	Negativ
corrupt	Econ@
drunkard	Negativ
dissent	Negativ
ironic	Negativ
worn	Negativ
indecision	Vice
immorality	Negativ
difficult	Negativ
inability	Negativ
arrogant	Negativ
bane	Negativ
infiltration	Negativ
limitation	Negativ
unlucky	Negativ
false	Negativ
rigorous	Negativ
devastation	Negativ
unnecessary	Negativ
animosity	Negativ
unfortunate	Negativ
carelessness	Negativ
dreary	Negativ
unsure	Vice
corruption	Negativ
refuse	Negativ
poverty	Econ@
horrid	Negativ
litter	Negativ
confuse	Negativ
indefinite	Negativ
discrimination	Vice
alarming	Negativ
consternation	Negativ
deadly	Negativ
suicide	Vice
disapproval	Negativ
absentee	Negativ
spot	Negativ
bleak	Negativ
damnable	Negativ
decadence	Negativ
unkind	Negativ
unwise	Negativ
plague	Negativ
roughness	Negativ
timid	Vice
bothersome	Negativ
repugnant	Negativ
painful	Negativ
stuffy	Negativ
preposterous	Negativ
precarious	Negativ
undependable	Negativ
extravagant	Econ@
craze	Negativ
beside	Vice
commotion	Negativ
assault	Negativ
hole	Econ@
trick	Negativ
regression	Negativ
notorious	Negativ
inferior	Negativ
carry	Vice
degenerate	Negativ
selfish	Negativ
skeptical	Negativ
crime	Legal
involve	Negativ
impure	Negativ
unsound	Negativ
vicious	Negativ
incapable	Negativ
deceit	Negativ
homely	Negativ
bizarre	Negativ
inaccessible	Negativ
diseased	Negativ
annihilation	Negativ
sickness	Negativ
despicable	Negativ
bore	Negativ
atrocious	Negativ
hesitant	Vice
roundabout	Negativ
deceitful	Negativ
sour	Negativ
shaggy	Negativ
barbarian	Negativ
broke	Econ@
helplessness	Negativ
untrue	Negativ
murder	Negativ
fussy	Negativ
hand	Negativ
blemish	Negativ
uncouth	Negativ
attack	Negativ
dope	Negativ
headache	Negativ
timidity	Negativ
inane	Negativ
irony	Negativ
vile	Negativ
cheater	Negativ
ignorance	Negativ
infamous	Negativ
fight	Milit
intervention	Milit
badly	Negativ
cynical	Negativ
conceit	Negativ
disobedient	Negativ
perilous	Negativ
affectation	Negativ
appall	Negativ
harm	Negativ
sin	Relig
boast	Negativ
dreadful	Negativ
insignificant	Negativ
crook	Negativ
sketchy	Negativ
bad	Negativ
presumptuous	Negativ
blame	Negativ
unjust	Legal
worse	Negativ
short	Negativ
boredom	Negativ
burn	Negativ
delusion	Negativ
condescension	Negativ
fracture	Negativ
sickly	Negativ
cheap	Econ@
crooked	Negativ
embarrassment	Negativ
sunburn	Vice
unstable	Negativ
unemployed	Econ@
injurious	Negativ
disruption	Negativ
petty	Negativ
horrible	Negativ
trauma	Negativ
unsatisfactory	Negativ
weakness	Vice
culprit	Negativ
grim	Negativ
reckless	Negativ
equivocal	Negativ
ingratitude	Negativ
meaningless	Negativ
abnormal	Negativ
stupidity	Negativ
limit	Negativ
destructive	Negativ
perverse	Negativ
ruin	Negativ
arduous	Negativ
shortcoming	Negativ
nonsense	Negativ
unpleasant	Negativ
unemployment	Econ@
beastly	Negativ
damned	Negativ
harsh	Negativ
nuisance	Negativ
unprepared	Vice
idiot	Negativ
tiresome	Negativ
unfit	Negativ
invalid	Negativ
fruitless	Negativ
adulteration	Negativ
circle	Negativ
queer	Negativ
blind	Negativ
indecent	Negativ
violent	Negativ
filth	Negativ
idle	Vice
defiance	Negativ
dependence	Vice
deadweight	Negativ
unchecked	Vice
cold	Polit@
catch	Negativ
complicity	Negativ
fail	Negativ
grotesque	Negativ
bankruptcy	Econ@
expensive	Econ@
offensive	Negativ
recalcitrant	Negativ
matter	Negativ
insecure	Negativ
aggressiveness	Negativ
disgrace	Negativ
bereavement	Negativ
derision	Negativ
disputable	Legal
inhibition	Negativ
drunken	Negativ
negligent	Legal
sluggish	Negativ
bound	Negativ
delinquent	Negativ
confrontation	Negativ
illegal	Legal
foolish	Negativ
deaf	Negativ
rupture	Negativ
formidable	Negativ
bow	Milit
recklessness	Negativ
harmful	Negativ
sly	Negativ
contemptible	Negativ
incompatibility	Negativ
barbarous	Negativ
troublesome	Negativ
coercion	Negativ
hectic	Negativ
ridiculous	Negativ
pervert	Negativ
impediment	Negativ
unjustified	Negativ
drunk	Negativ
lazy	Negativ
mundane	Negativ
strict	Negativ
rude	Negativ
filthy	Negativ
temptation	Negativ
insane	Negativ
stupid	Negativ
monotonous	Negativ
severity	Negativ
unsoundness	Vice
incompatible	Negativ
lost	Negativ
costly	Econ@
clutter	Negativ
confinement	Negativ
unfaithful	Negativ
scum	Negativ
crafty	Negativ
dilemma	Negativ
wrought	Negativ
strike	Econ@
hazardous	Negativ
liquidation	Econ@
stubborn	Negativ
undue	Negativ
unfriendly	Negativ
unqualified	Negativ
dissention	Negativ
handicap	Negativ
idiotic	Negativ
void	Negativ
discouragement	Negativ
unpopular	Negativ
misbehavior	Negativ
hesitation	Vice
bankrupt	Econ@
burglary	Negativ
foreign	Negativ
feeble	Negativ
abject	Negativ
error	Negativ
misfortune	Negativ
horn	Exprsv
adverse	Negativ
negation	Negativ
irrational	Negativ
unclear	Negativ
foolishness	Negativ
doubtful	Negativ
puny	Negativ
cancer	Negativ
dunce	Negativ
rat	Negativ
deficiency	Negativ
restrict	Negativ
defeat	Negativ
inexact	Negativ
vice	Legal
pinch	Negativ
unauthentic	Negativ
illegality	Legal
chaos	Negativ
disturbance	Negativ
fanatic	Negativ
aggression	Negativ
silly	Negativ
ominous	Negativ
head	Academ
dirty	Negativ
avarice	Negativ
rampant	Negativ
backwardness	Negativ
negligence	Legal
desolate	Negativ
hindrance	Negativ
rotten	Negativ
banal	Negativ
illness	Negativ
unattractive	Negativ
wound	Negativ
sort	Negativ
covert	Negativ
too	Negativ
vulnerability	Vice
ignoble	Negativ
decadent	Negativ
shady	Negativ
rash	Negativ
stolen	Legal
worst	Negativ
violation	Legal
deficit	Econ@
aggravation	Negativ
cursory	Negativ
unsuccessful	Negativ
mistake	Negativ
egotistical	Negativ
improper	Negativ
frail	Vice
aghast	Negativ
irresponsible	Negativ
violence	Negativ
fabrication	Negativ
stick	Negativ
severe	Negativ
coarseness	Negativ
whip	Negativ
imperfect	Negativ
manner	Vice
awkward	Negativ
insidious	Negativ
damage	Negativ
awkwardness	Negativ
crass	Negativ
awful	Negativ
guilty	Legal
crash	Vice
worthless	Negativ
weird	Negativ
arbitrary	Negativ
vanity	Negativ
unfamiliar	Negativ
tedious	Negativ
forgetfulness	Negativ
inadequate	Negativ
mean	Negativ
vulnerable	Vice
ludicrous	Negativ
hypocrisy	Negativ
confiscation	Negativ
condescending	Negativ
counterfeit	Negativ
bother	Negativ
infringement	Legal
relentless	Vice
artificial	Negativ
flu	Vice
dangerous	Negativ
drab	Negativ
hypocrite	Negativ
steal	Legal
defiant	Negativ
envious	Negativ
insufficient	Negativ
misuse	Negativ
resistance	Vice
useless	Negativ
slothful	Negativ
tyranny	Polit@
affliction	Negativ
incorrect	Negativ
lunatic	Negativ
doom	Negativ
madness	Negativ
stunt	Negativ
vulgar	Negativ
hazard	Negativ
demon	Negativ
disaster	Negativ
ghastly	Negativ
fever	Negativ
cannibal	Negativ
withdrawn	Vice
derisive	Negativ
ignorant	Negativ
evil	Negativ
cynicism	Negativ
unworthy	Negativ
blindness	Negativ
mar	Negativ
unbelievable	Negativ
interference	Negativ
wrongful	Negativ
unexpectedly	Negativ
havoc	Negativ
fix	Negativ
butchery	Negativ
monstrous	Negativ
static	Negativ
unmitigated	Vice
tragic	Negativ
busybody	Negativ
destruction	Negativ
avenge	Negativ
loveless	Negativ
disease	Negativ
ragged	Vice
obnoxious	Negativ
arrogance	Negativ
cruel	Negativ
monotony	Negativ
loss	Negativ
scoundrel	Negativ
deafness	Negativ
adversity	Negativ
odd	Negativ
deception	Negativ
sinister	Negativ
insecurity	Negativ
unreliability	Negativ
wastefulness	Negativ
hardship	Negativ
undesirable	Negativ
excessive	Negativ
absurdity	Negativ
deceive	Negativ
burden	Negativ
disorganized	Negativ
burglar	Negativ
creep	Vice
vain	Negativ
hideous	Negativ
failure	Negativ
manslaughter	Legal
rascal	Negativ
ugly	Negativ
abominable	Negativ
redundancy	Negativ
consumptive	Negativ
dismal	Negativ
shoot	Exprsv
particular	Negativ
bogus	Negativ
undignified	Negativ
turmoil	Negativ
unreal	Vice
wear	Negativ
unscrupulous	Negativ
defective	Negativ
disobedience	Negativ
mess	Negativ
poor	Econ@
wasteful	Negativ
brat	Negativ
unimportant	Negativ
absurd	Negativ
emergency	Negativ
idleness	Negativ
wrinkle	Negativ
disorder	Negativ
chronic	Negativ
predicament	Negativ
distraction	Negativ
brutish	Negativ
fault	Negativ
blockhead	Negativ
contemptuous	Negativ
craziness	Negativ
inhumane	Negativ
study	Academ
disadvantage	Negativ
unfair	Negativ
brutality	Negativ
terrible	Negativ
depraved	Negativ
strife	Negativ
impetuous	Negativ
catastrophe	Negativ
waste	Econ@
chaotic	Negativ
dearth	Negativ
pretentious	Negativ
accursed	Negativ
venom	Negativ
bribe	Econ@
uttermost	Positiv
understood	Positiv
triumphal	Positiv
inaugurate	Positiv
stimulate	Positiv
confide	Positiv
abound	Positiv
staple	Positiv
supportive	Positiv
exalt	Positiv
substantiate	Positiv
mild	Positiv
attend	Positiv
kid	Exprsv
backer	Econ@
imperative	Positiv
ensemble	Positiv
conqueror	Positiv
reconciliation	Positiv
acquittal	Legal
asset	Positiv
energize	Positiv
sweeten	Positiv
affirmation	Positiv
consideration	Positiv
commonsense	Positiv
necessarily	Positiv
association	Positiv
onward	Positiv
longevity	Positiv
fidelity	Positiv
communicate	Positiv
verify	Positiv
dignified	Positiv
prodigy	Positiv
pass	Legal
novelty	Positiv
matchless	Positiv
ripe	Positiv
beneficiary	Econ@
conserve	Positiv
privileged	Econ@
eminence	Positiv
conducive	Positiv
intelligible	Positiv
glisten	Positiv
surge	Positiv
hygiene	Positiv
momentous	Positiv
inform	Positiv
company	Econ@
bargain	Econ@
live	Econ@
populous	Positiv
utilize	Positiv
upside	Positiv
accompaniment	Positiv
bonus	Econ@
worthiness	Positiv
fascination	Positiv
enlightenment	Positiv
mobility	Positiv
intercede	Positiv
gusto	Positiv
flatter	Positiv
concession	Positiv
protector	Positiv
commemorate	Positiv
playmate	Positiv
blossom	Positiv
deservedly	Positiv
subscribe	Positiv
celebration	Positiv
lustrous	Positiv
extravagance	Positiv
conquest	Positiv
unforgettable	Positiv
savvy	Positiv
modernity	Positiv
warm	Positiv
mindful	Positiv
buoyant	Positiv
proprietary	Positiv
smile	Positiv
recompense	Econ@
commendation	Positiv
curtsey	Positiv
visualization	Positiv
formality	Positiv
luxurious	Positiv
connect	Positiv
breadwinner	Econ@
communal	Positiv
immortal	Positiv
educational	Academ
monumental	Positiv
beautify	Positiv
solution	Positiv
saint	Relig
inherit	Econ@
coordinate	Positiv
embellish	Positiv
admittance	Positiv
protect	Positiv
salute	Legal
consensus	Positiv
succeed	Positiv
reassurance	Positiv
bloom	Positiv
assistant	Positiv
individuality	Positiv
welcome	Positiv
potent	Positiv
coincident	Positiv
persevere	Positiv
relevant	Positiv
hug	Positiv
befit	Positiv
renaissance	Positiv
patriot	Polit@
outright	Positiv
affluence	Econ@
agreement	Positiv
outwit	Positiv
brainy	Positiv
invaluable	Econ@
donate	Econ@
heaven	Relig
relevance	Positiv
adjunct	Positiv
familiarity	Positiv
betrothal	Econ@
idol	Positiv
communicative	Positiv
unique	Positiv
candor	Positiv
heal	Positiv
civil	Milit
complete	Positiv
elaborate	Positiv
legal	Legal
call	Positiv
melody	Exprsv
guardian	Positiv
exertion	Positiv
deduce	Positiv
revive	Positiv
correction	Positiv
forward	Positiv
sparkle	Positiv
frugal	Econ@
home	Positiv
temperance	Positiv
agreeable	Positiv
alive	Positiv
hallowed	Positiv
temperate	Positiv
revelation	Positiv
reestablish	Positiv
crusader	Polit@
sweetheart	Positiv
polish	Positiv
bequeath	Econ@
kiss	Positiv
adhesion	Positiv
deal	Econ@
clout	Positiv
cultivation	Positiv
onset	Positiv
subsistence	Positiv
distinction	Positiv
negotiate	Positiv
thankful	Positiv
comprehend	Positiv
gold	Econ@
logical	Positiv
glitter	Positiv
pro	Positiv
sturdy	Positiv
generate	Positiv
remedy	Positiv
mesh	Positiv
contribution	Positiv
affiliation	Positiv
propriety	Positiv
augment	Positiv
caress	Positiv
glow	Positiv
nurture	Positiv
cognizance	Positiv
indispensable	Positiv
suffice	Positiv
complementary	Positiv
mentor	Positiv
competency	Positiv
descry	Positiv
fearless	Positiv
consolidate	Positiv
praise	Positiv
privacy	Positiv
fortify	Positiv
aristocratic	Econ@
eye	Legal
art	Academ
infer	Positiv
inference	Positiv
confederation	Polit@
cheer	Positiv
economize	Econ@
beauteous	Positiv
absorption	Positiv
firmness	Positiv
consent	Positiv
dexterity	Positiv
jointly	Positiv
defend	Positiv
flashy	Positiv
tolerate	Positiv
farsighted	Positiv
steadfast	Positiv
partnership	Econ@
perfume	Positiv
steadiness	Positiv
stable	Positiv
lavish	Positiv
affiliate	Positiv
topmost	Positiv
nobleman	Econ@
credentials	Positiv
togetherness	Positiv
ensure	Positiv
prowess	Positiv
ceaseless	Positiv
compliance	Positiv
culminate	Positiv
restore	Positiv
flexible	Positiv
righteousness	Positiv
conclusive	Positiv
innovate	Positiv
exult	Positiv
amenity	Positiv
stand	Positiv
welfare	Econ@
interpose	Positiv
stood	Positiv
festival	Positiv
purposeful	Positiv
ingenuity	Positiv
multitude	Positiv
perfectionist	Positiv
distinguished	Positiv
vivid	Positiv
cohort	Positiv
classic	Academ
thrive	Positiv
associate	Econ@
energetic	Positiv
proffer	Positiv
prominence	Positiv
adhesive	Positiv
impervious	Positiv
ascribe	Positiv
softness	Positiv
radiant	Positiv
motivation	Positiv
reverence	Positiv
restoration	Positiv
cognizant	Positiv
subsidize	Econ@
interested	Positiv
harmonize	Positiv
quench	Positiv
permit	Legal
anoint	Positiv
utilitarian	Positiv
feast	Positiv
paradise	Relig
resound	Positiv
prance	Positiv
benefit	Econ@
congratulate	Positiv
squarely	Positiv
quicken	Positiv
champ	Positiv
brotherly	Positiv
afloat	Econ@
partner	Econ@
definitive	Positiv
absorbent	Positiv
lifelong	Positiv
reassure	Positiv
unlimited	Positiv
comedy	Exprsv
steadfastness	Positiv
gain	Econ@
everlasting	Positiv
astound	Positiv
patron	Econ@
notable	Positiv
statuesque	Positiv
chum	Positiv
groom	Positiv
human	Positiv
steady	Positiv
strut	Positiv
baptize	Positiv
renewal	Positiv
aggregation	Positiv
rapt	Positiv
attain	Positiv
obedience	Positiv
potency	Positiv
surpass	Positiv
uppermost	Positiv
enable	Positiv
distinctive	Positiv
hero	Positiv
acquit	Legal
heroine	Positiv
advocacy	Positiv
rally	Polit@
entertain	Exprsv
sleek	Positiv
reparation	Positiv
boundless	Positiv
upheld	Legal
laudable	Positiv
profit	Econ@
frolic	Positiv
affluent	Econ@
redemption	Positiv
stud	Positiv
tactics	Polit@
impetus	Positiv
resurrect	Positiv
inquisitive	Positiv
signify	Positiv
heartily	Positiv
mutual	Positiv
sanity	Positiv
nominate	Polit@
studious	Positiv
humanity	Positiv
reverently	Positiv
godlike	Positiv
motive	Positiv
arbitration	Positiv
navigable	Positiv
painstaking	Positiv
consultation	Positiv
magnetic	Positiv
accord	Positiv
offer	Positiv
compensate	Econ@
idolize	Positiv
dawn	Positiv
avid	Positiv
civilization	Positiv
aware	Positiv
boost	Positiv
intricate	Positiv
liberate	Positiv
conquer	Positiv
capitalize	Econ@
staunchness	Positiv
peerless	Positiv
enhance	Positiv
excel	Positiv
realistically	Positiv
outrun	Positiv
savings	Econ@
verification	Positiv
glamour	Positiv
capability	Positiv
brightness	Positiv
ethics	Positiv
accountable	Positiv
light	Positiv
noiseless	Positiv
proficient	Positiv
repent	Positiv
authority	Legal
champion	Positiv
allied	Polit@
festivity	Positiv
sanctify	Positiv
success	Positiv
abundance	Positiv
captivation	Positiv
aggregate	Positiv
applause	Positiv
renovation	Positiv
empower	Positiv
vastness	Positiv
playful	Positiv
fragrant	Positiv
justify	Positiv
flourish	Positiv
invitation	Positiv
obtain	Positiv
ceremonial	Positiv
precaution	Positiv
profess	Positiv
unhurried	Positiv
marriage	Positiv
prolific	Positiv
achieve	Positiv
appease	Positiv
greet	Positiv
attune	Positiv
accession	Positiv
fulfillment	Positiv
woo	Positiv
arbitrate	Positiv
graduation	Academ
edible	Positiv
indescribable	Positiv
plausibility	Positiv
successful	Positiv
flattery	Positiv
tranquil	Positiv
comeback	Positiv
pay	Econ@
guide	Econ@
survival	Positiv
dazzle	Positiv
familiarize	Positiv
confidant	Positiv
coherent	Positiv
tempt	Positiv
back	Positiv
advent	Positiv
fertile	Positiv
accomplish	Positiv
concur	Positiv
amply	Positiv
outset	Positiv
fullness	Positiv
sober	Positiv
sanctuary	Positiv
poignant	Positiv
straightforward	Positiv
allowable	Positiv
trophy	Positiv
idealism	Positiv
arbiter	Positiv
award	Positiv
distinct	Positiv
facilitate	Positiv
commodious	Positiv
complement	Positiv
rouse	Positiv
preeminent	Positiv
attendance	Positiv
audible	Positiv
attract	Positiv
precept	Positiv
enrich	Positiv
grandeur	Positiv
apprehend	Positiv
nurse	Econ@
overcome	Positiv
marvel	Positiv
abide	Positiv
outlive	Positiv
comprehensive	Positiv
advisable	Positiv
forgive	Positiv
major	Academ
allow	Positiv
salutation	Positiv
engage	Positiv
riches	Econ@
learner	Academ
contribute	Econ@
aspiration	Positiv
clear	Econ@
outgoing	Positiv
alliance	Polit@
fruition	Positiv
decipher	Positiv
thrifty	Econ@
picturesque	Positiv
thrift	Econ@
adorn	Positiv
law	Legal
befitting	Positiv
oasis	Relig
acknowledgement	Positiv
consult	Positiv
durability	Positiv
colleague	Positiv
ardent	Positiv
staunch	Positiv
allowance	Econ@
give	Positiv
cure	Positiv
safeguard	Positiv
amazement	Positiv
lyrical	Exprsv
reinstate	Legal
subsist	Positiv
imagination	Exprsv
brilliance	Positiv
privy	Positiv
ripen	Positiv
glorify	Positiv
arisen	Positiv
companionship	Positiv
exotic	Positiv
discuss	Positiv
prodigious	Positiv
memorable	Positiv
zenith	Positiv
patriotic	Polit@
console	Positiv
haven	Positiv
endorse	Positiv
etiquette	Positiv
dare	Positiv
preparatory	Positiv
accentuate	Positiv
affix	Positiv
championship	Positiv
alleviate	Positiv
meticulous	Positiv
treatise	Legal
exultation	Positiv
fashionable	Positiv
moralistic	Positiv
upright	Positiv
minister	Relig
fabulous	Positiv
abundant	Positiv
sought	Positiv
realistic	Positiv
delicacy	Positiv
goodbye	Positiv
nourishment	Positiv
honeymoon	Positiv
originality	Positiv
plaything	Positiv
commend	Positiv
manageable	Positiv
glimmer	Positiv
cohesion	Positiv
insight	Positiv
clearness	Positiv
contributor	Positiv
reap	Positiv
thank	Positiv
reinforcement	Positiv
myriad	Positiv
fill	Econ@
coddle	Positiv
backbone	Positiv
auspicious	Positiv
aristocrat	Econ@
symbolize	Positiv
defense	Positiv
commune	Positiv
inexpensive	Econ@
logic	Positiv
durable	Positiv
robust	Positiv
luster	Positiv
mate	Positiv
bright	Positiv
lucid	Positiv
uphold	Legal
tenacity	Positiv
intercourse	Positiv
save	Econ@
commission	Positiv
upfront	Positiv
garnish	Positiv
candid	Positiv
importance	Positiv
amazing	Positiv
revitalize	Positiv
traditional	Positiv
niche	Positiv
embrace	Positiv
portable	Positiv
compromise	Positiv
prize	Positiv
shelter	Positiv
assurance	Positiv
dance	Exprsv
adherent	Positiv
summit	Positiv
adventurous	Positiv
sprightly	Positiv
mend	Positiv
fame	Positiv
rapture	Positiv
reunion	Positiv
assent	Positiv
factual	Positiv
inauguration	Positiv
make	Negativ
semblance	Positiv
speedily	Positiv
permission	Positiv
plain	Positiv
accrue	Econ@
pomp	Positiv
marital	Positiv
lover	Positiv
prosperous	Econ@
donation	Econ@
meet	Positiv
joke	Exprsv
principal	Positiv
morality	Positiv
attentive	Positiv
revere	Positiv
equity	Econ@
rightful	Legal
relevancy	Positiv
brilliant	Positiv
achievement	Positiv
nourish	Positiv
approach	Positiv
liberalism	Polit@
clarify	Positiv
standardize	Positiv
primarily	Positiv
join	Positiv
maturity	Positiv
rave	Positiv
premise	Positiv
industrious	Positiv
fellow	Positiv
plenty	Positiv
deserve	Positiv
approval	Positiv
intrigue	Positiv
advancement	Positiv
lively	Positiv
obedient	Positiv
rapport	Positiv
gorgeous	Positiv
chic	Positiv
tribute	Positiv
accomplishment	Positiv
richness	Econ@
swiftness	Positiv
even	Negativ
accede	Positiv
pledge	Polit@
poise	Positiv
lucrative	Econ@
luxuriant	Positiv
prosper	Econ@
soothe	Positiv
amplify	Positiv
counsel	Legal
reconcile	Positiv
accept	Positiv
travel	Positiv
forgiven	Positiv
reverent	Positiv
natural	Positiv
knowledge	Academ
subsidy	Econ@
comely	Positiv
synthesis	Positiv
consummate	Positiv
compliment	Positiv
entertainment	Exprsv
receptive	Positiv
cleanse	Positiv
cogent	Positiv
symmetry	Positiv
masterful	Positiv
repair	Positiv
gift	Positiv
order	Negativ
condone	Positiv
covenant	Positiv
bountiful	Positiv
feasible	Positiv
repentance	Positiv
coax	Positiv
create	Exprsv
tradition	Positiv
inventor	Positiv
readily	Positiv
attractiveness	Positiv
baptism	Positiv
persuasive	Positiv
remodel	Positiv
revival	Positiv
survive	Positiv
luminous	Positiv
flaunt	Positiv
dominance	Positiv
communion	Relig
community	Positiv
council	Polit@
impunity	Legal
colossal	Positiv
independence	Polit@
foster	Positiv
harness	Positiv
fitness	Positiv
patronage	Econ@
survivor	Positiv
conjure	Exprsv
provide	Positiv
credibility	Positiv
festive	Positiv
instinctive	Positiv
obey	Positiv
coexistence	Positiv
uncommon	Positiv
sagacity	Positiv
glossy	Positiv
irresistible	Positiv
reclaim	Positiv
betroth	Econ@
laugh	Exprsv
triumph	Positiv
mastery	Positiv
awareness	Positiv
lyric	Exprsv
autonomous	Legal
admit	Positiv
offset	Positiv
reunite	Positiv
cooperate	Positiv
indomitable	Positiv
boom	Econ@
commemoration	Positiv
backing	Positiv
devout	Positiv
convince	Positiv
guarantee	Legal
augmentation	Positiv
contact	Positiv
shield	Positiv
acceptance	Positiv
desirous	Positiv
redeem	Positiv
pleasantry	Positiv
collaborate	Positiv
adherence	Positiv
plentiful	Positiv
sworn	Legal
acquaint	Positiv
affirm	Positiv
closeness	Positiv
fulfill	Positiv
precedent	Legal
civilize	Positiv
settle	Positiv
wondrous	Positiv
allies	Positiv
upward	Positiv
aspire	Positiv
elaboration	Positiv
ameliorate	Positiv
appreciable	Positiv
nobility	Econ@
bolster	Positiv
illuminate	Positiv
affirmative	Positiv
congratulatory	Positiv
justice	Legal
surmise	Positiv
accommodate	Positiv
rehabilitation	Positiv
fresh	Positiv
deference	Positiv
amnesty	Legal
adjustable	Positiv
workmanship	Positiv
consider	Positiv
marry	Positiv
shiny	Positiv
accordance	Positiv
endurance	Positiv
dignify	Positiv
utilization	Positiv
endow	Econ@
impress	Positiv
subscription	Positiv
forgave	Positiv
sage	Positiv
vanquish	Positiv
unbound	Positiv
visionary	Positiv
familiar	Positiv
treaty	Polit@
ally	Polit@
aristocracy	Econ@
enhancement	Positiv
celebrity	Positiv
conjunction	Positiv
pardon	Positiv
extol	Positiv
absolve	Positiv
genius	Positiv
congregate	Positiv
scruples	Positiv
surmount	Positiv
crusade	Polit@
glamorous	Positiv
ample	Positiv
commencement	Positiv
nimble	Positiv
prosecute	Legal
great	Positiv
mobilize	Positiv
filial	Positiv
mediate	Positiv
piety	Relig
magical	Relig
completion	Positiv
assuredly	Positiv
constancy	Positiv
education	Academ
righteous	Positiv
dauntless	Positiv
stimulation	Positiv
tenacious	Positiv
radiance	Positiv
befriend	Positiv
liberty	Polit@
measurable	Positiv
bestow	Positiv
enrichment	Positiv
know	Positiv
delicate	Positiv
scamper	Positiv
confer	Positiv
oblige	Positiv
consign	Positiv
append	Positiv
continuity	Positiv
convene	Positiv
protective	Positiv
friend	Positiv
culmination	Positiv
defender	Positiv
acquaintance	Positiv
illustrious	Positiv
posterity	Positiv
gleam	Positiv
vouchsafe	Positiv
golden	Positiv
exquisite	Positiv
appoint	Positiv
clarity	Positiv
radiate	Positiv
inseparable	Positiv
dig	Positiv
credible	Positiv
comprehension	Positiv
renovate	Positiv
glean	Positiv
discern	Positiv
indicative	Positiv
obtainable	Positiv
premier	Positiv
witty	Positiv
laughter	Exprsv
moderation	Positiv
main	Positiv
attainment	Positiv
hope	Positiv
applaud	Positiv
commensurate	Positiv
venerate	Positiv
companion	Positiv
congratulation	Positiv
prohibit	Legal
swore	Negativ
aggravate	Negativ
debtor	Econ@
guise	Negativ
desert	Negativ
wearisome	Negativ
accusation	Negativ
secession	Polit@
gamble	Econ@
torrent	Negativ
fought	Negativ
wicked	Negativ
withheld	Negativ
fist	Negativ
alien	Negativ
outcast	Negativ
spinster	Negativ
mishap	Negativ
commoner	Econ@
succumb	Negativ
piece	Econ@
lawless	Legal
conceal	Negativ
divert	Negativ
rebut	Negativ
inhibit	Negativ
worsen	Negativ
spear	Milit
sinful	Negativ
war	Milit
mangle	Negativ
stagnant	Negativ
low	Negativ
contagious	Negativ
refusal	Negativ
brawl	Negativ
scoff	Negativ
pandemonium	Negativ
atrophy	Negativ
complaint	Negativ
dark	Negativ
scowl	Negativ
thirst	Negativ
controversial	Negativ
sufferer	Negativ
inflation	Econ@
violate	Negativ
hobble	Negativ
congestion	Negativ
dying	Negativ
gullible	Negativ
cost	Econ@
inferiority	Negativ
backward	Negativ
lag	Negativ
freak	Negativ
shake	Negativ
hag	Negativ
blur	Negativ
encroachment	Negativ
wild	Negativ
heinous	Negativ
immature	Negativ
rivalry	Negativ
shadow	Negativ
unequal	Negativ
jar	Negativ
argument	Negativ
laid	Econ@
falsehood	Negativ
whack	Negativ
impede	Negativ
prisoner	Legal
bury	Negativ
accuse	Legal
slash	Negativ
accost	Negativ
mislead	Negativ
spoil	Negativ
detain	Negativ
dim	Negativ
refrain	Negativ
dwindle	Negativ
tantrum	Negativ
terrorism	Negativ
sucker	Negativ
shrug	Negativ
melodramatic	Exprsv
calamity	Negativ
altercation	Negativ
suffocate	Negativ
scuffle	Negativ
lay	Econ@
esoteric	Negativ
bewilder	Negativ
compel	Negativ
stern	Negativ
indictment	Legal
disavowal	Negativ
delay	Negativ
bewilderment	Negativ
cancel	Negativ
retaliate	Negativ
depose	Negativ
monster	Negativ
overlook	Negativ
sap	Negativ
scheme	Negativ
frivolous	Negativ
uproot	Negativ
expedient	Negativ
exempt	Negativ
rattle	Negativ
rubbish	Negativ
deterrent	Negativ
persecute	Negativ
dispute	Negativ
screw	Negativ
stalemate	Negativ
antiquated	Negativ
jeer	Negativ
discriminate	Negativ
kick	Negativ
brusque	Negativ
slam	Negativ
rebuff	Negativ
run	Econ@
slump	Negativ
malady	Negativ
problem	Negativ
resignation	Negativ
defensive	Negativ
balk	Negativ
offender	Negativ
death	Negativ
conspiracy	Polit@
shoddy	Negativ
forsake	Negativ
stubbornly	Negativ
tease	Negativ
provoke	Negativ
implicate	Negativ
provocation	Negativ
besiege	Negativ
bout	Negativ
vagabond	Econ@
jail	Legal
sarcasm	Negativ
bomb	Milit
darn	Negativ
snore	Negativ
haggard	Negativ
shirk	Negativ
club	Milit
denial	Negativ
drown	Negativ
barrier	Negativ
noise	Negativ
exile	Negativ
drowsy	Negativ
expense	Econ@
disbelief	Negativ
prowl	Negativ
vex	Negativ
unsafe	Negativ
recede	Negativ
fighter	Negativ
insensible	Negativ
inefficiency	Negativ
spill	Negativ
contaminate	Negativ
precipitate	Negativ
starvation	Negativ
misunderstanding	Negativ
loom	Negativ
intruder	Negativ
conspire	Negativ
senile	Negativ
topple	Negativ
lowly	Negativ
alas	Negativ
retreat	Milit
capitulate	Negativ
peril	Negativ
helpless	Negativ
ration	Negativ
knife	Negativ
push	Negativ
defame	Negativ
explosive	Negativ
outburst	Negativ
ghetto	Negativ
bafflement	Negativ
tatter	Negativ
discordant	Negativ
retard	Negativ
darken	Negativ
unnoticed	Negativ
shark	Negativ
entangle	Polit@
flimsy	Negativ
rebel	Negativ
unnatural	Negativ
fretful	Negativ
exit	Negativ
bullet	Negativ
subvert	Negativ
substitution	Negativ
collide	Negativ
congested	Negativ
flaw	Negativ
casualty	Negativ
fuss	Negativ
volatility	Negativ
defile	Negativ
demolish	Negativ
fraught	Negativ
wait	Negativ
din	Negativ
detract	Negativ
unavoidable	Negativ
quitter	Negativ
blast	Negativ
quarrel	Negativ
shipwreck	Negativ
prohibition	Legal
doomsday	Negativ
lure	Negativ
capture	Negativ
wench	Negativ
plod	Negativ
hell	Relig
convict	Legal
haunt	Negativ
vomit	Negativ
warlike	Polit@
knock	Negativ
darkness	Negativ
foreboding	Negativ
decease	Negativ
hamper	Negativ
inexplicable	Negativ
anarchy	Polit@
cancellation	Negativ
censorship	Negativ
ambiguous	Negativ
hater	Negativ
contradiction	Negativ
muddle	Negativ
warp	Negativ
mischief	Negativ
manipulation	Negativ
fugitive	Legal
foible	Negativ
omit	Negativ
rusty	Negativ
exclude	Negativ
sentence	Legal
bug	Negativ
break	Legal
discharge	Milit
blunder	Negativ
intimidate	Negativ
protest	Negativ
infect	Negativ
stormy	Negativ
absent	Negativ
slaughter	Negativ
motley	Negativ
oddity	Negativ
opposition	Negativ
liable	Negativ
feverish	Negativ
dispense	Negativ
implore	Negativ
wanton	Negativ
nullify	Negativ
transgress	Negativ
lazily	Negativ
disregard	Negativ
susceptible	Negativ
accident	Negativ
paralysis	Negativ
jeopardy	Negativ
vengeance	Negativ
feud	Negativ
dispel	Negativ
immobility	Negativ
lifeless	Negativ
overbearing	Negativ
jerk	Negativ
crushing	Negativ
anomalous	Negativ
dirt	Negativ
stab	Negativ
stammer	Negativ
mischievous	Negativ
vie	Negativ
vagueness	Negativ
colony	Polit@
crumple	Negativ
harass	Negativ
deter	Negativ
motionless	Negativ
stifle	Negativ
alibi	Negativ
combatant	Negativ
mistrust	Negativ
sputter	Negativ
culpable	Negativ
complex	Negativ
empty	Negativ
corrode	Negativ
meager	Negativ
killer	Negativ
scarcity	Negativ
extinguish	Negativ
lying	Negativ
stringent	Negativ
brazen	Negativ
incredible	Negativ
undid	Negativ
coarse	Negativ
beg	Negativ
execute	Negativ
refugee	Polit@
bar	Exprsv
germ	Negativ
wrestle	Negativ
addiction	Negativ
abandon	Negativ
secrecy	Negativ
miss	Negativ
perplexity	Negativ
shot	Negativ
abandonment	Negativ
tax	Econ@
discrepant	Negativ
usurp	Polit@
scream	Negativ
incompetence	Negativ
parasite	Negativ
astray	Negativ
stray	Negativ
erode	Negativ
collision	Negativ
crush	Negativ
assail	Negativ
decline	Negativ
hustle	Econ@
gratuitous	Negativ
clash	Negativ
dump	Negativ
feign	Negativ
screech	Negativ
throw	Negativ
obstruct	Negativ
runaway	Negativ
unseen	Negativ
ineffectiveness	Negativ
rogue	Negativ
ambush	Milit
exception	Negativ
fiasco	Negativ
invade	Polit@
disprove	Negativ
novice	Negativ
race	Negativ
chastise	Negativ
disarm	Negativ
deprive	Negativ
unaccustomed	Negativ
meek	Negativ
depreciate	Negativ
annihilate	Negativ
fallacy	Negativ
malignant	Negativ
slayer	Negativ
deviation	Negativ
baffle	Negativ
cannon	Milit
bloodthirsty	Negativ
chase	Negativ
nosey	Negativ
denounce	Negativ
faint	Negativ
rough	Negativ
counteract	Negativ
elimination	Negativ
object	Negativ
misbehave	Negativ
underworld	Econ@
sloppy	Negativ
loser	Negativ
beware	Negativ
naughty	Negativ
hustler	Econ@
collapse	Negativ
abdicate	Negativ
sever	Negativ
dead	Negativ
admonish	Negativ
conspirator	Negativ
enemy	Negativ
avoid	Negativ
insinuate	Negativ
adversary	Polit@
villain	Negativ
hungry	Negativ
snare	Negativ
deny	Negativ
cram	Negativ
owe	Econ@
smear	Negativ
drowsiness	Negativ
engulf	Negativ
complain	Negativ
rumple	Negativ
farce	Negativ
gloat	Negativ
taunt	Negativ
senseless	Negativ
kidnap	Legal
ruffian	Negativ
nix	Negativ
disclaim	Negativ
illogical	Negativ
opponent	Negativ
fatal	Negativ
cool	Negativ
hinder	Negativ
dismiss	Negativ
slanderous	Negativ
ramble	Negativ
belated	Negativ
depreciation	Econ@
quibble	Negativ
superfluous	Negativ
inconsistency	Negativ
contradict	Negativ
enforce	Legal
irregularity	Negativ
subservience	Negativ
diabolic	Negativ
obstacle	Negativ
subside	Negativ
pitiful	Negativ
commonplace	Negativ
wayward	Negativ
afflict	Negativ
shove	Negativ
struggle	Negativ
disapprove	Negativ
shabby	Negativ
stupor	Negativ
founder	Negativ
demise	Negativ
inaccuracy	Negativ
hunter	Exprsv
argue	Negativ
assassinate	Negativ
orphan	Negativ
storm	Negativ
pointless	Negativ
vague	Negativ
ineffectual	Negativ
misrepresent	Negativ
avert	Negativ
subjugate	Negativ
assailant	Negativ
complexity	Negativ
infraction	Legal
bandit	Negativ
deadlock	Negativ
obstruction	Negativ
division	Negativ
hang	Negativ
standstill	Negativ
renounce	Negativ
shrivel	Negativ
buckle	Negativ
overthrow	Negativ
trivial	Negativ
marginal	Negativ
encroach	Negativ
careen	Negativ
subversion	Negativ
breach	Negativ
capsize	Negativ
eliminate	Negativ
rot	Negativ
perish	Negativ
crude	Negativ
let	Negativ
reject	Negativ
interrupt	Negativ
point	Negativ
merciless	Negativ
pompous	Negativ
counteraction	Negativ
recoil	Negativ
curtail	Negativ
pollute	Legal
ruthless	Negativ
restriction	Legal
confine	Negativ
falter	Negativ
pretend	Negativ
dominate	Negativ
contradictory	Negativ
pretense	Negativ
blurt	Negativ
loner	Negativ
credulous	Negativ
epithet	Negativ
dissatisfy	Negativ
agitator	Negativ
abyss	Negativ
overrun	Negativ
drought	Negativ
adulterate	Negativ
battlefield	Negativ
molest	Negativ
vexing	Negativ
charge	Econ@
intrude	Negativ
ambiguity	Negativ
cumbersome	Negativ
condemn	Negativ
drag	Negativ
confession	Negativ
coward	Negativ
smother	Negativ
startle	Negativ
prosecution	Legal
bit	Negativ
erase	Negativ
oppress	Negativ
blunt	Negativ
goddamn	Negativ
lurk	Negativ
complicate	Negativ
avoidance	Negativ
interfere	Negativ
imprison	Legal
incessant	Negativ
taboo	Negativ
procrastinate	Negativ
betrayal	Negativ
overflow	Negativ
rival	Negativ
obliterate	Negativ
antagonist	Negativ
sequester	Legal
get	Negativ
procrastination	Negativ
bloody	Negativ
fleeting	Negativ
bland	Negativ
dictate	Polit@
secret	Negativ
twitch	Negativ
slanderer	Negativ
obsolete	Negativ
explosion	Negativ
need	Negativ
tramp	Negativ
admonition	Negativ
irregular	Negativ
treason	Polit@
truant	Legal
wane	Negativ
guerrilla	Milit
subjugation	Negativ
needy	Negativ
dependent	Negativ
recession	Econ@
plot	Negativ
confess	Negativ
corrosion	Negativ
propaganda	Polit@
suspension	Negativ
ride	Negativ
witchcraft	Negativ
venomous	Negativ
fat	Negativ
negate	Negativ
invisible	Negativ
limp	Negativ
dishonest	Negativ
insolence	Negativ
liquidate	Econ@
rip	Negativ
gunmen	Negativ
feint	Negativ
patronize	Negativ
scandalous	Negativ
belie	Negativ
bolt	Negativ
croak	Negativ
wilt	Negativ
amputate	Negativ
oppression	Negativ
nuts	Negativ
fled	Negativ
indeterminate	Negativ
starve	Negativ
disguise	Negativ
sarcastic	Negativ
drive	Negativ
blackmail	Econ@
erroneous	Negativ
uncivil	Negativ
devastate	Negativ
distort	Negativ
abrupt	Negativ
ultimatum	Negativ
fake	Negativ
straggle	Negativ
aggrieve	Negativ
lose	Negativ
curse	Negativ
flounder	Negativ
disrupt	Negativ
unlawful	Legal
seize	Negativ
hunt	Negativ
robber	Legal
expose	Negativ
mishandle	Negativ
ridicule	Negativ
tariff	Econ@
wreck	Negativ
pry	Negativ
differ	Negativ
excess	Negativ
suspect	Legal
ferocity	Negativ
undermine	Negativ
fabricate	Negativ
root	Negativ
combat	Polit@
overworked	Negativ
distracting	Negativ
snatch	Negativ
collusion	Negativ
suppression	Negativ
degrade	Negativ
stamp	Econ@
absence	Negativ
treasonous	Polit@
rebellion	Milit
dent	Negativ
segregation	Negativ
terrorize	Negativ
unobserved	Negativ
derogatory	Negativ
oppose	Negativ
fraud	Negativ
brandish	Negativ
crumble	Negativ
neglect	Negativ
disposal	Negativ
untruth	Negativ
fragile	Negativ
repeal	Legal
wrath	Negativ
paltry	Negativ
liar	Negativ
scandal	Negativ
volatile	Negativ
regress	Negativ
insult	Negativ
slap	Negativ
weed	Negativ
turn	Negativ
horde	Negativ
crawl	Negativ
fret	Negativ
poison	Negativ
competition	Negativ
stole	Legal
extinct	Negativ
isolate	Negativ
struck	Negativ
nightmare	Negativ
sunder	Negativ
pick	Negativ
mine	Econ@
grapple	Negativ
punish	Negativ
ravage	Negativ
embarrass	Negativ
bereft	Negativ
intrusion	Negativ
injunction	Legal
clique	Negativ
hollow	Negativ
constraint	Negativ
punch	Negativ
alarm	Negativ
nasty	Negativ
tamper	Negativ
endanger	Negativ
infuriate	Negativ
shortage	Negativ
subjection	Negativ
choke	Negativ
slander	Negativ
belittle	Negativ
turbulent	Negativ
fidget	Negativ
battle	Milit
aimless	Negativ
destroy	Negativ
stubbornness	Negativ
fumble	Negativ
block	Negativ
treachery	Negativ
revert	Negativ
autocrat	Polit@
unsteadiness	Negativ
cheapen	Negativ
untrained	Negativ
confront	Negativ
sank	Negativ
sleepless	Negativ
fool	Negativ
unhealthy	Negativ
boot	Negativ
miser	Econ@
vagrant	Econ@
ostracize	Negativ
viper	Negativ
interruption	Negativ
corrosive	Negativ
thief	Legal
inundated	Negativ
contrary	Negativ
exterminate	Negativ
default	Econ@
indulge	Negativ
barren	Negativ
scapegoat	Negativ
reactionary	Polit@
betray	Negativ
infest	Negativ
intoxicate	Negativ
boisterous	Negativ
suppress	Negativ
assassin	Negativ
paralyzed	Negativ
bait	Negativ
devilish	Negativ
nullification	Negativ
uproar	Negativ
costliness	Econ@
devoid	Negativ
snarl	Negativ
decay	Negativ
misinform	Negativ
utterance	Negativ
heedless	Negativ
rebuke	Negativ
tear	Negativ
weariness	Negativ
smuggle	Negativ
alienate	Negativ
gaudy	Negativ
veto	Negativ
confiscate	Negativ
raid	Negativ
abolish	Negativ
coercive	Negativ
pound	Negativ
toil	Negativ
flagrant	Negativ
shortsighted	Negativ
illiterate	Negativ
unreasonable	Negativ
prison	Legal
upheaval	Negativ
temporarily	Negativ
skirmish	Negativ
bravado	Negativ
rebellious	Polit@
perplex	Negativ
abscond	Negativ
untimely	Negativ
torment	Negativ
ineffective	Negativ
reproach	Negativ
competitor	Negativ
immovable	Negativ
daunting	Negativ
outbreak	Negativ
leak	Negativ
horrify	Negativ
disagreement	Negativ
incurable	Negativ
oblique	Negativ
enslave	Polit@
pessimistic	Negativ
blah	Negativ
worrier	Negativ
distortion	Negativ
uneven	Negativ
box	Exprsv
secede	Polit@
brittle	Negativ
squander	Econ@
lapse	Negativ
droop	Negativ
taint	Negativ
undone	Negativ
hedge	Negativ
shred	Negativ
skulk	Negativ
chide	Negativ
pitiless	Negativ
resent	Negativ
decrease	Negativ
weaken	Negativ
vanish	Negativ
scold	Negativ
chore	Negativ
languish	Negativ
erosion	Negativ
diabolical	Negativ
offend	Negativ
excommunication	Legal
partition	Negativ
theft	Legal
wickedness	Negativ
strangle	Negativ
allege	Negativ
bum	Econ@
sleazy	Negativ
austere	Negativ
mutter	Negativ
mediocre	Negativ
compulsion	Negativ
inundate	Negativ
belt	Negativ
devil	Relig
mock	Negativ
scorch	Negativ
grab	Negativ
displease	Negativ
breakdown	Negativ
brag	Negativ
shrew	Negativ
addict	Negativ
sabotage	Negativ
trudge	Negativ
mumble	Negativ
revolt	Polit@
insufficiency	Negativ
feudal	Polit@
unarm	Negativ
defy	Negativ
drop	Negativ
cave	Negativ
hazy	Negativ
exaggeration	Negativ
asunder	Negativ
fire	Econ@
undo	Negativ
sneer	Negativ
plaintiff	Legal
thud	Negativ
blatant	Negativ
tempest	Negativ
exploit	Negativ
fatalistic	Negativ
slight	Negativ
disingenuous	Negativ
wily	Negativ
threaten	Negativ
quit	Negativ
unforeseen	Negativ
sedentary	Negativ
pathetic	Negativ
frigid	Negativ
servitude	Negativ
famished	Negativ
wee	Negativ
stark	Negativ
overturn	Legal
imprisonment	Legal
vexation	Negativ
forbid	Negativ
floor	Negativ
prod	Negativ
entanglement	Polit@
kill	Negativ
unruly	Negativ
explode	Negativ
rid	Negativ
banish	Polit@
warfare	Milit
thwart	Negativ
bail	Negativ
eccentricity	Negativ
eradicate	Negativ
harassment	Negativ
bombard	Negativ
curt	Negativ
uninformed	Negativ
revolution	Polit@
epidemic	Negativ
persecution	Negativ
nebulous	Negativ
dictatorial	Polit@
ruthlessness	Negativ
straggler	Negativ
lower	Negativ
diversion	Negativ
frown	Negativ
incompetent	Negativ
inequality	Negativ
liability	Negativ
misunderstood	Negativ
manipulate	Negativ
fallout	Negativ
bombardment	Negativ
omission	Negativ
haphazard	Negativ
misunderstand	Negativ
tardy	Negativ
shell	Milit
deplore	Negativ
misinformed	Negativ
relapse	Negativ
seethe	Negativ
bereave	Negativ
scrutinize	Negativ
revoke	Negativ
fall	Negativ
anomaly	Negativ
bungle	Negativ
junk	Negativ
passe	Negativ
abate	Negativ
devious	Negativ
impasse	Negativ
humiliate	Negativ
aggressor	Negativ
sneak	Negativ
obscure	Negativ
regardless	Negativ
annoy	Negativ
defendant	Negativ
retire	Negativ
massacre	Negativ
evasion	Negativ
grumble	Negativ
flee	Negativ
censor	Negativ
subtract	Negativ
deluge	Negativ
entreat	Negativ
discredit	Negativ
mistaken	Negativ
anarchist	Polit@
frantically	Negativ
cataclysm	Negativ
repulse	Negativ
coerce	Negativ
mockery	Negativ
savage	Negativ
debatable	Negativ
deride	Negativ
err	Negativ
haziness	Negativ
hackney	Negativ
constrain	Negativ
siege	Polit@
trap	Negativ
indeterminable	Negativ
allegation	Legal
overwhelming	Negativ
thorny	Negativ
deplete	Negativ
eccentric	Negativ
autocratic	Polit@
rumor	Negativ
close	Negativ
lie	Negativ
submissive	Negativ
unsteady	Negativ
unguarded	Negativ
smack	Negativ
censure	Negativ
evict	Legal
babble	Negativ
inflame	Negativ
decompose	Negativ
dawdle	Negativ
dungeon	Negativ
disproportionate	Negativ
hunger	Negativ
revenge	Negativ
daze	Negativ
distract	Negativ
shroud	Negativ
stain	Negativ
clog	Negativ
shallow	Negativ
inconvenient	Negativ
jumpy	Negativ
withhold	Negativ
divide	Negativ
spank	Negativ
quarrelsome	Negativ
murky	Negativ
displace	Negativ
meddle	Negativ
gun	Milit
slime	Negativ
robbery	Legal
dumb	Negativ
criminal	Legal
damn	Negativ
banishment	Polit@
outsider	Negativ
powerless	Negativ
muddy	Negativ
outlaw	Legal
gruff	Negativ
leakage	Negativ
forfeit	Negativ
show	Exprsv
demean	Negativ
insolent	Negativ
nag	Negativ
jeopardize	Negativ
disavow	Negativ
thrash	Negativ
scar	Negativ
dull	Negativ
blow	Negativ
deceptive	Negativ
sag	Negativ
contend	Negativ
raise	Econ@
uprising	Negativ
bastard	Negativ
growl	Negativ
captive	Negativ
compete	Negativ
yawn	Negativ
deviate	Negativ
hoard	Negativ
expel	Negativ
extermination	Negativ
overpower	Negativ
impose	Negativ
split	Negativ
infection	Negativ
impair	Negativ
lull	Negativ
shyness	Negativ
exhaust	Negativ
forbidden	Negativ
fraudulent	Negativ
oust	Negativ
agitate	Negativ
inflict	Negativ
rigor	Negativ
swear	Negativ
against	Negativ
nonchalant	Negativ
shun	Negativ
suspend	Negativ
ax	Legal
beggar	Econ@
murderous	Negativ
unprofitable	Econ@
exclusion	Negativ
whine	Negativ
demoralize	Negativ
needle	Negativ
evade	Negativ
traitor	Negativ
beseech	Negativ
trespass	Negativ
foe	Negativ
iron	Polit@
disable	Negativ
thirsty	Negativ
criticize	Negativ
behead	Negativ
menial	Negativ
glare	Negativ
repudiate	Negativ
fiend	Negativ
critic	Exprsv
poisonous	Negativ
renunciation	Negativ
trample	Negativ
neutralize	Negativ
lame	Negativ
pessimism	Negativ
exasperate	Negativ
queen	Polit@
ideology	Polit@
election	Polit@
representative	Polit@
kingdom	Polit@
empire	Polit@
municipality	Polit@
palace	Polit@
governmental	Polit@
communism	Econ@
conference	Polit@
sovereignty	Polit@
senate	Polit@
party	Exprsv
politics	Polit@
king	Polit@
white	Econ@
ship	Polit@
prince	Polit@
royalty	Polit@
legislative	Legal
minutemen	Milit
precinct	Polit@
sovereign	Polit@
imperial	Polit@
platform	Polit@
armistice	Milit
league	Polit@
commissioner	Polit@
state	Polit@
border	Polit@
county	Polit@
diplomacy	Polit@
politician	Polit@
census	Polit@
commonwealth	Polit@
ruler	Polit@
frontier	Polit@
coalition	Polit@
international	Polit@
ministry	Polit@
tribe	Polit@
chancellor	Polit@
utopian	Polit@
campaign	Polit@
federation	Polit@
poll	Polit@
congressmen	Polit@
vote	Polit@
congressional	Polit@
constitutional	Polit@
tactic	Polit@
democratic	Polit@
legislator	Legal
debate	Polit@
convention	Polit@
federal	Polit@
senator	Polit@
settlement	Polit@
parliament	Polit@
junta	Legal
political	Polit@
tribal	Polit@
establishment	Econ@
mayor	Polit@
statesman	Polit@
left	Polit@
corps	Milit
imperialist	Polit@
union	Econ@
voter	Polit@
socialism	Polit@
lord	Polit@
campaigner	Polit@
labor	Econ@
republican	Polit@
utopia	Polit@
secretary	Econ@
exchange	Econ@
victory	Polit@
court	Legal
president	Polit@
confederate	Polit@
delegation	Polit@
dictator	Polit@
rule	Legal
surrender	Milit
government	Polit@
interstate	Polit@
presidency	Polit@
petition	Polit@
crown	Polit@
regime	Polit@
statesmen	Polit@
ballot	Polit@
table	Polit@
colonial	Polit@
governor	Polit@
demonstration	Polit@
tory	Polit@
administration	Polit@
capitalism	Econ@
bill	Econ@
capitol	Polit@
dictatorship	Polit@
emperor	Polit@
national	Polit@
democrat	Polit@
minority	Polit@
municipal	Polit@
amendment	Legal
ambassador	Polit@
spokesman	Polit@
reds	Polit@
presidential	Polit@
royal	Polit@
constitution	Polit@
liberation	Polit@
jurisdiction	Legal
elite	Polit@
diplomatic	Polit@
govern	Polit@
villager	Polit@
elect	Polit@
nation	Polit@
partisan	Polit@
country	Polit@
body	Polit@
draft	Milit
metropolis	Polit@
socialist	Polit@
legislation	Legal
flag	Polit@
nomination	Polit@
revolutionary	Polit@
conservatism	Polit@
republic	Polit@
delegate	Polit@
legion	Milit
congress	Polit@
communist	Econ@
society	Polit@
embassy	Polit@
metropolitan	Polit@
primary	Polit@
congressman	Polit@
house	Polit@
candidate	Polit@
citizen	Polit@
cabinet	Polit@
conservative	Polit@
province	Polit@
social	Econ@
magic	Relig
orthodox	Relig
congregational	Relig
ecumenical	Relig
ghost	Relig
parish	Relig
god	Relig
cult	Relig
reverend	Relig
easter	Relig
gospel	Relig
preach	Relig
stoicism	Relig
metaphysics	Relig
theology	Relig
seminary	Academ
seeker	Relig
soul	Relig
eternal	Relig
catholic	Relig
goddess	Relig
pope	Relig
theological	Relig
bishop	Relig
christ	Relig
sermon	Relig
testament	Legal
biblical	Relig
clergyman	Relig
zen	Relig
pray	Relig
religion	Relig
fate	Relig
bible	Relig
rector	Relig
christmas	Relig
hymn	Relig
christian	Relig
christianity	Relig
denominational	Relig
metaphysical	Relig
crucifix	Relig
worship	Relig
chapel	Relig
believer	Relig
pastor	Relig
congregation	Relig
myth	Relig
pilgrimage	Relig
preacher	Relig
missionary	Relig
convert	Relig
prayer	Relig
priest	Relig
witch	Relig
church	Relig
cathedral	Relig
attorney	Legal
warrant	Legal
statute	Legal
juror	Legal
constable	Legal
entitle	Legal
policemen	Legal
certify	Legal
registration	Legal
auditor	Econ@
issue	Legal
private	Milit
sheriff	Legal
certification	Legal
advocate	Legal
patent	Legal
stipulation	Legal
hear	Legal
judicial	Legal
litigation	Legal
lawyer	Legal
witness	Legal
case	Legal
apply	Legal
authorize	Legal
evidence	Legal
police	Legal
posse	Legal
detective	Legal
title	Legal
litigant	Legal
jury	Legal
summon	Legal
contract	Econ@
cop	Legal
proprietor	Econ@
stipulate	Legal
deposition	Legal
agent	Legal
statutory	Legal
owner	Legal
ordinance	Legal
sanction	Legal
oath	Legal
proceed	Econ@
judgment	Legal
testimony	Legal
probation	Legal
license	Legal
officiate	Legal
certificate	Legal
judge	Legal
official	Legal
enforcement	Legal
solicitor	Legal
testify	Legal
trial	Legal
marshall	Legal
verdict	Legal
policeman	Legal
arrow	Milit
colonel	Milit
weapon	Milit
submarine	Milit
coup	Milit
soldier	Milit
veteran	Milit
rocket	Milit
military	Milit
marcher	Milit
pistol	Milit
regiment	Milit
naval	Milit
recruit	Milit
sergeant	Milit
troop	Milit
fleet	Milit
militia	Milit
navy	Milit
corporal	Milit
guard	Milit
general	Milit
grenade	Milit
patrol	Milit
cavalry	Milit
stronghold	Milit
munition	Milit
rifle	Milit
castle	Milit
missile	Milit
blockade	Milit
army	Milit
armed	Milit
destroyer	Milit
ammunition	Milit
infantry	Milit
fort	Milit
tnt	Milit
trigger	Milit
march	Milit
lieutenant	Milit
parade	Milit
sword	Milit
warrior	Milit
air	Milit
arm	Milit
pentagon	Milit
commander	Milit
guitar	Exprsv
figure	Exprsv
catcher	Exprsv
assignment	Exprsv
symphonic	Exprsv
perform	Exprsv
opera	Exprsv
hop	Exprsv
conductor	Exprsv
football	Exprsv
music	Exprsv
field	Exprsv
sculpture	Exprsv
sung	Exprsv
bowl	Exprsv
star	Exprsv
whistle	Exprsv
story	Exprsv
symbol	Exprsv
poetry	Exprsv
baseball	Exprsv
prose	Exprsv
artistic	Exprsv
fashion	Exprsv
musician	Exprsv
picture	Exprsv
tale	Exprsv
play	Exprsv
player	Exprsv
marksman	Exprsv
roll	Exprsv
speech	Exprsv
draw	Exprsv
piano	Exprsv
performance	Exprsv
anecdote	Exprsv
performer	Exprsv
gymnast	Exprsv
racer	Exprsv
image	Exprsv
theater	Exprsv
concert	Exprsv
studio	Exprsv
paint	Exprsv
sang	Exprsv
streamer	Exprsv
runner	Exprsv
essay	Academ
drama	Exprsv
poet	Exprsv
spectator	Exprsv
imagine	Exprsv
orchestra	Exprsv
imaginable	Exprsv
write	Exprsv
joker	Exprsv
creator	Exprsv
row	Exprsv
sketch	Exprsv
match	Exprsv
singer	Exprsv
pace	Exprsv
poem	Exprsv
bandstand	Exprsv
satire	Exprsv
swam	Exprsv
camp	Exprsv
walker	Exprsv
drum	Exprsv
giant	Exprsv
pool	Exprsv
gallery	Exprsv
wave	Exprsv
dancer	Exprsv
song	Exprsv
trumpet	Exprsv
vacation	Exprsv
stage	Exprsv
symbolism	Exprsv
traveler	Exprsv
bard	Exprsv
tourist	Econ@
verse	Exprsv
science	Academ
composer	Exprsv
tune	Exprsv
novelist	Exprsv
theatre	Exprsv
narrative	Exprsv
expression	Exprsv
dramatic	Exprsv
boxer	Exprsv
expressive	Exprsv
camera	Exprsv
legend	Exprsv
rock	Exprsv
maker	Exprsv
medal	Exprsv
architect	Exprsv
painter	Exprsv
swim	Exprsv
derby	Exprsv
architecture	Exprsv
invent	Exprsv
literature	Academ
swimmer	Exprsv
imaginary	Exprsv
artist	Exprsv
movie	Exprsv
verbal	Exprsv
quartet	Exprsv
stadium	Exprsv
record	Exprsv
fence	Exprsv
fiction	Exprsv
tennis	Exprsv
biography	Exprsv
literary	Academ
symphony	Exprsv
novel	Exprsv
keyboard	Exprsv
imagery	Exprsv
written	Exprsv
author	Exprsv
writer	Exprsv
hide	Exprsv
ornament	Exprsv
portrait	Exprsv
musical	Exprsv
orator	Exprsv
aesthetic	Exprsv
jazz	Exprsv
actor	Exprsv
bridge	Exprsv
express	Exprsv
violin	Exprsv
saga	Exprsv
ski	Exprsv
sing	Exprsv
gymnastic	Exprsv
sail	Exprsv
bat	Exprsv
property	Econ@
debt	Econ@
port	Econ@
incorporate	Econ@
mill	Econ@
hire	Econ@
trade	Econ@
gardener	Econ@
payment	Econ@
mechanic	Econ@
copper	Econ@
toll	Econ@
sponsor	Econ@
miner	Econ@
client	Econ@
technology	Econ@
laboratory	Academ
teamster	Econ@
currency	Econ@
pasture	Econ@
distributor	Econ@
barn	Econ@
investment	Econ@
expenditure	Econ@
career	Econ@
cannery	Econ@
plumber	Econ@
gross	Econ@
cafe	Econ@
motel	Econ@
plow	Econ@
agency	Econ@
miller	Econ@
ticket	Econ@
belong	Econ@
consultant	Econ@
grower	Econ@
personnel	Econ@
repaid	Econ@
seaman	Econ@
custom	Econ@
designer	Econ@
producer	Econ@
fish	Econ@
employee	Econ@
grant	Econ@
job	Econ@
servant	Econ@
factory	Econ@
store	Econ@
fund	Econ@
salesmen	Econ@
dentist	Econ@
invest	Econ@
operator	Econ@
supplier	Econ@
dealer	Econ@
merchant	Econ@
barber	Econ@
manager	Econ@
slave	Econ@
butcher	Econ@
tailor	Econ@
maid	Econ@
fiscal	Econ@
profession	Econ@
room	Econ@
vocational	Econ@
syndicate	Econ@
zinc	Econ@
price	Econ@
harvest	Econ@
peasant	Econ@
technological	Econ@
baker	Econ@
hanger	Econ@
lent	Econ@
employer	Econ@
landlord	Econ@
specialist	Econ@
fee	Econ@
financial	Econ@
wholesale	Econ@
flyer	Econ@
salesman	Econ@
economics	Academ
rental	Econ@
livestock	Econ@
merchandise	Econ@
slavery	Econ@
afford	Econ@
waiter	Econ@
estimate	Econ@
ranch	Econ@
publish	Econ@
consume	Econ@
managerial	Econ@
utility	Econ@
metal	Econ@
cash	Econ@
taxation	Econ@
harbor	Econ@
hotel	Econ@
occupation	Econ@
insurance	Econ@
payroll	Econ@
oil	Econ@
boss	Econ@
manufacture	Econ@
bet	Econ@
monopoly	Econ@
purchase	Econ@
exchequer	Econ@
charter	Econ@
check	Econ@
valuation	Econ@
product	Econ@
plant	Econ@
earn	Econ@
finance	Econ@
employment	Econ@
aluminum	Econ@
tobacco	Econ@
expend	Econ@
undertaker	Econ@
uranium	Econ@
agricultural	Econ@
sale	Econ@
executive	Econ@
auction	Econ@
repay	Econ@
management	Econ@
taxable	Econ@
freight	Econ@
farmer	Econ@
bank	Econ@
borrow	Econ@
office	Econ@
professional	Econ@
treasurer	Econ@
pilot	Econ@
industry	Econ@
loan	Econ@
ledger	Econ@
refund	Econ@
worker	Econ@
mortgage	Econ@
foundation	Econ@
businessmen	Econ@
shipment	Econ@
commodity	Econ@
taxpayer	Econ@
coachman	Econ@
reporter	Econ@
nickel	Econ@
planer	Econ@
restaurant	Econ@
budget	Econ@
economy	Econ@
commercial	Econ@
manufacturer	Econ@
newspaperman	Econ@
commerce	Econ@
agriculture	Econ@
trader	Econ@
bid	Econ@
farm	Econ@
workshop	Econ@
craft	Econ@
industrial	Econ@
firm	Econ@
teller	Econ@
planner	Econ@
carpenter	Econ@
possession	Econ@
engineer	Econ@
rancher	Econ@
porter	Econ@
employ	Econ@
income	Econ@
boatswain	Econ@
import	Econ@
cent	Econ@
roofer	Econ@
revenue	Econ@
businessman	Econ@
post	Econ@
technician	Econ@
bought	Econ@
economic	Econ@
journalist	Econ@
livelihood	Econ@
wage	Econ@
goods	Econ@
technical	Econ@
market	Econ@
editor	Econ@
coin	Econ@
business	Econ@
cheat	Econ@
seamen	Econ@
corp	Econ@
plantation	Econ@
promote	Econ@
consumer	Econ@
produce	Econ@
clerk	Econ@
dollar	Econ@
controller	Econ@
newsmen	Econ@
sell	Econ@
lend	Econ@
builder	Econ@
cheque	Econ@
lab	Academ
slum	Econ@
user	Econ@
cook	Econ@
money	Econ@
doctor	Econ@
collective	Econ@
salesmanship	Econ@
surgeon	Econ@
win	Econ@
enrollment	Econ@
output	Econ@
bookkeeping	Econ@
pension	Econ@
overseer	Econ@
department	Econ@
payer	Econ@
planter	Econ@
inventory	Econ@
corporation	Econ@
fare	Econ@
ranger	Econ@
yield	Econ@
banker	Econ@
ownership	Econ@
salary	Econ@
treasury	Econ@
walk	Econ@
insure	Econ@
rent	Econ@
janitor	Econ@
broker	Econ@
investor	Econ@
shop	Econ@
monetary	Econ@
seller	Econ@
promotion	Econ@
guild	Econ@
retail	Econ@
laborer	Econ@
account	Econ@
discount	Econ@
occupational	Econ@
earner	Econ@
enterprise	Econ@
subscriber	Econ@
sweep	Econ@
customer	Econ@
consumption	Econ@
mineral	Econ@
boarder	Econ@
sold	Econ@
brand	Econ@
tractor	Econ@
philosophical	Academ
college	Academ
grade	Academ
schoolroom	Academ
freshmen	Academ
statistics	Academ
student	Academ
classroom	Academ
graduate	Academ
campus	Academ
historical	Academ
freshman	Academ
questionnaire	Academ
platonism	Academ
scientific	Academ
library	Academ
literalness	Academ
dean	Academ
history	Academ
form	Academ
museum	Academ
examiner	Academ
philosophic	Academ
examination	Academ
semester	Academ
junior	Academ
letter	Academ
pupil	Academ
instructor	Academ
theoretical	Academ
teach	Academ
psychological	Academ
lesson	Academ
nutrition	Academ
word	Academ
proctor	Academ
read	Academ
english	Academ
scholarship	Academ
taught	Academ
physician	Academ
faculty	Academ
scholar	Academ
astronomy	Academ
experiment	Academ
school	Academ
examine	Academ
teacher	Academ
scientist	Academ
psychiatrist	Academ
math	Academ
professor	Academ
sociology	Academ
discourse	Academ
senior	Academ
academy	Academ
instruction	Academ
geometry	Academ
historian	Academ
coach	Academ
university	Academ
counselor	Academ
theory	Academ
philosopher	Academ
physicist	Academ
matriculate	Academ
biological	Academ
exam	Academ
instruct	Academ
research	Academ
grind	Academ
institute	Academ
high	Academ
course	Academ
educate	Academ
chemistry	Academ
degree	Academ
statistical	Academ
typography	Academ
thinker	Academ
grammar	Academ
physics	Academ
academic	Academ
dr	Academ
lecture	Academ
undergraduate	Academ
pta	Academ
linguist	Academ
mathematical	Academ
sociological	Academ
historic	Academ
experimental	Academ
clinical	Academ
psychologist	Academ
test	Academ
text	Academ
mathematics	Academ
scholastic	Academ
