Term	Category
zeal	Pleasur
tenderness	Positiv
fun	Exprsv
respite	Positiv
romance	Positiv
cheerful	Positiv
devote	Positiv
game	Exprsv
cozy	Positiv
ecstasy	Positiv
therapeutic	Positiv
hot	Negativ
delight	Positiv
jubilee	Positiv
relieve	Positiv
cuddle	Positiv
harmonious	Positiv
appeal	Legal
poetic	Exprsv
warmhearted	Positiv
dreamland	Positiv
admire	Positiv
calmness	Positiv
comfort	Positiv
lust	Positiv
decorative	Positiv
carefree	Positiv
repose	Positiv
restful	Positiv
cheery	Positiv
pride	Positiv
gaiety	Positiv
merrily	Positiv
excitement	Positiv
rejoice	Positiv
determine	EMOT
adore	Positiv
attraction	Positiv
love	Positiv
assure	Positiv
joy	Positiv
please	Positiv
appreciative	Positiv
fantasy	Positiv
gladden	Positiv
refuge	Positiv
happiness	Positiv
earnest	Positiv
satisfy	Positiv
comic	Positiv
contentment	Positiv
jest	Positiv
bliss	Positiv
delightful	Positiv
enthusiasm	Positiv
intimacy	Positiv
relish	Positiv
willing	Positiv
decoration	Positiv
enthusiastic	Positiv
decorate	Positiv
elate	Positiv
ease	Positiv
satisfaction	Positiv
blithe	Positiv
sublime	Positiv
amour	Positiv
amusement	Positiv
pleasant	Positiv
merry	Positiv
relief	Positiv
secure	Positiv
uplift	Positiv
celebrate	Positiv
admiration	Positiv
resolve	Positiv
gay	Positiv
smitten	Positiv
relaxation	Positiv
endear	Positiv
flirt	Positiv
gladness	Positiv
content	Positiv
jubilant	Positiv
calm	Positiv
balmy	Positiv
appreciation	Positiv
comical	Positiv
comfortable	Positiv
whimsical	Relig
sanguine	Positiv
glad	Positiv
exhilaration	Positiv
enjoy	Positiv
hilarious	Positiv
value	Positiv
gratify	Positiv
recline	Positiv
savor	Positiv
romantic	Positiv
blissful	Positiv
ecstatic	Positiv
fascinate	Arousal
amuse	Positiv
gaily	Positiv
dote	Positiv
tranquility	Positiv
confident	Positiv
jolly	Positiv
sweetness	Positiv
rest	Pleasur
happy	Positiv
thrill	Positiv
triumphant	Positiv
recreation	Positiv
rosy	Positiv
willingness	Positiv
mirth	Positiv
fondness	Positiv
humorous	Positiv
excite	Positiv
pleasure	Positiv
merriment	Positiv
spirit	Relig
proud	Positiv
tingle	Positiv
pleased	Positiv
humor	Positiv
joyful	Positiv
pleasurable	Positiv
optimistic	Positiv
apocalypse	Positiv
excited	Positiv
indulgence	Positiv
eager	Positiv
cupid	Positiv
purr	Positiv
gratification	Positiv
comestible	Positiv
grateful	Positiv
revel	Positiv
overjoyed	Positiv
attachment	Positiv
confidence	Positiv
adulation	Positiv
glee	Positiv
enchantment	Positiv
exhaustion	Negativ
lone	Negativ
scared	Negativ
nervousness	Negativ
desperation	Negativ
bitterness	Negativ
wretchedness	Negativ
horror	Negativ
shame	Negativ
somber	Negativ
sorrowful	Negativ
disappointment	Negativ
unwilling	Negativ
sad	Negativ
forlorn	Negativ
wallow	Negativ
stress	Negativ
unassured	Pain
wretch	Negativ
unwillingness	Negativ
ailment	Negativ
frustration	Negativ
gloomy	Negativ
gash	Negativ
neurotic	Negativ
depression	Econ@
exasperation	Negativ
frightful	Negativ
hostile	Negativ
whimper	Negativ
sadness	Negativ
lamentable	Negativ
nervous	Negativ
rue	Negativ
sorrow	Negativ
dread	Negativ
tense	Negativ
grief	Negativ
shriek	Negativ
anxiousness	Negativ
fury	Negativ
bruise	Negativ
fed	Negativ
dishonor	Negativ
dissolution	Negativ
hysteria	Negativ
moan	Negativ
indignation	Negativ
discomfort	Negativ
burdensome	Negativ
sprain	Negativ
brood	Negativ
unhappy	Negativ
oppressive	Negativ
miserable	Negativ
ashamed	Negativ
stricken	Negativ
writhe	Negativ
grievance	Negativ
ail	Negativ
guilt	Negativ
doldrums	Negativ
smart	Positiv
weary	EMOT
pout	Negativ
resentment	Negativ
cramp	Negativ
discontent	Negativ
irritation	Negativ
apprehensive	Negativ
frustrate	Negativ
malice	Negativ
numb	Negativ
blue	Econ@
discourage	Negativ
uneasy	Negativ
bitter	Negativ
thoughtless	Negativ
intolerable	Negativ
soreness	Negativ
lonely	Negativ
injure	Negativ
dissatisfaction	Negativ
loneliness	Negativ
sore	Negativ
displeasure	Negativ
estranged	Negativ
chafe	Negativ
disappoint	Negativ
ill	Negativ
torturous	Negativ
hung	Negativ
dishearten	Negativ
hard	Negativ
press	Econ@
wary	Negativ
weep	Negativ
shameful	Negativ
hysterical	Negativ
frighten	Negativ
trouble	Negativ
beset	Negativ
cringe	Negativ
disgust	Negativ
regret	Negativ
clatter	Negativ
commiseration	Negativ
hurt	Negativ
lonesome	Negativ
despise	Negativ
dissatisfied	Negativ
mourn	Negativ
shrill	Negativ
sob	Negativ
depress	Negativ
tragedy	Negativ
irk	Negativ
outrage	Negativ
disturb	Negativ
wince	Negativ
commit	Negativ
fatigue	Negativ
downhearted	Negativ
fearsome	Negativ
malicious	Negativ
bloodshed	Negativ
irritable	Negativ
concern	Econ@
glum	Negativ
plight	Negativ
agony	Negativ
grizzly	Negativ
apprehension	Negativ
touchy	Negativ
shiver	Negativ
unnerve	Negativ
conflict	Negativ
apologetic	Pain
strain	Negativ
disconcerted	Negativ
uneasiness	Negativ
cripple	Negativ
despair	Negativ
melancholy	Negativ
terror	Negativ
unhappiness	Negativ
restlessness	Negativ
tired	Negativ
hurtful	Negativ
famine	Negativ
scrape	Negativ
anguish	Negativ
shock	Negativ
scald	Negativ
anxious	Negativ
destitute	Econ@
disagreeable	Negativ
remorse	Negativ
mourner	Negativ
downcast	Negativ
mortify	Negativ
scare	Negativ
dismay	EMOT
downfall	Negativ
gloom	Negativ
sorry	Negativ
clamorous	Negativ
scary	Negativ
regrettable	Negativ
pain	Negativ
upset	Negativ
hopeless	Negativ
disillusion	EMOT
hostility	Negativ
suffer	Negativ
woe	Negativ
tolerable	Negativ
distress	Negativ
ache	Negativ
edge	Negativ
humiliation	Negativ
worry	Negativ
perturb	Negativ
uncomfortable	Negativ
unsettling	Negativ
frantic	Negativ
panic	Negativ
agonize	Negativ
grudge	Negativ
resentful	Negativ
grieve	Negativ
wind	Pain
sting	Negativ
afraid	Negativ
clamor	Negativ
lament	Negativ
sullen	Negativ
tension	Negativ
unbearable	Negativ
terrify	Negativ
misery	Negativ
stink	Negativ
dizzy	Negativ
desperate	Negativ
unspeakable	Negativ
yelp	Negativ
anxiety	Negativ
tire	Negativ
woeful	Negativ
fear	Negativ
fearful	Negativ
dejected	Negativ
distrustful	Negativ
wail	Negativ
optional	Positiv
eagerness	Positiv
exuberant	Positiv
rigid	Negativ
superstition	Negativ
optimism	Positiv
involuntary	Negativ
cranky	Negativ
opinionated	Negativ
repress	Negativ
voluntary	Positiv
apathy	Negativ
esteem	Positiv
fervent	Positiv
willful	Positiv
antipathy	Negativ
fiery	Positiv
exuberance	Positiv
covet	Negativ
prejudicial	Negativ
vigilant	Positiv
yearn	Negativ
entrust	Positiv
preference	Positiv
aloof	Negativ
earnestness	Positiv
superstitious	Negativ
unfeeling	Negativ
selfishness	Negativ
unmoved	Negativ
qualm	Negativ
fervor	Positiv
vehement	Negativ
vigilance	Positiv
obstinate	Negativ
positiveness	Positiv
resolved	Positiv
crave	Negativ
apathetic	Negativ
objection	Negativ
gratitude	Positiv
resolute	Positiv
outcry	Negativ
giddy	Positiv
dislike	Negativ
sympathetic	Positiv
mind	Negativ
move	Arousal
modesty	Positiv
reluctant	Negativ
readiness	Arousal
suspense	Arousal
serene	Positiv
affection	Positiv
furious	Negativ
inspirational	Positiv
temper	Negativ
respect	Positiv
seriousness	Positiv
pamper	Positiv
disposition	Arousal
homage	Positiv
dispose	Negativ
impulse	Arousal
question	Arousal
suspicion	Negativ
surprise	Virtue
emotion	EMOT
bashful	Negativ
berserk	Negativ
abhor	Negativ
passive	Arousal
feel	EMOT
acrimony	Negativ
sense	Positiv
insistent	Positiv
notoriety	Positiv
astonish	Arousal
acrimonious	Negativ
angry	Negativ
devotion	Relig
touch	Exprsv
quandary	Negativ
wide	Arousal
sympathy	Positiv
ready	Arousal
wonder	Positiv
antagonize	Negativ
adamant	Positiv
cross	Relig
meditation	Positiv
bite	Negativ
annoyance	Negativ
awe	EMOT
pity	EMOT
challenge	Negativ
sensitivity	Positiv
antagonistic	Negativ
fond	Positiv
assertion	Positiv
belligerent	Negativ
responsive	Positiv
emotional	EMOT
mellow	Positiv
distrust	Arousal
sentimental	EMOT
serious	Positiv
determination	Arousal
like	Positiv
antagonism	Negativ
hate	Negativ
watch	Arousal
swoon	Positiv
attitude	EMOT
impatience	Negativ
trust	Econ@
shy	EMOT
alert	Arousal
anticipation	Arousal
anticipate	Arousal
understand	Positiv
placid	Arousal
care	Positiv
heat	Arousal
anger	Negativ
appetite	Arousal
sentiment	EMOT
unexpected	Arousal
restless	Negativ
inspiration	Positiv
try	Legal
mood	EMOT
mad	Negativ
intimate	Positiv
confound	Negativ
prejudice	Negativ
suspicious	Negativ
preoccupation	Arousal
regard	Positiv
aversion	Negativ
indifference	Negativ
puzzlement	Negativ
sympathize	Positiv
heart	Positiv
preoccupy	Arousal
spend	Econ@
zest	Positiv
peaceable	Positiv
sensitive	Positiv
overwhelm	Arousal
amaze	Arousal
affectionate	Positiv
passionate	Positiv
restraint	Arousal
impartiality	Positiv
appreciate	Positiv
motivate	Positiv
will	Legal
bristle	Negativ
genial	Positiv
rage	Negativ
morale	Positiv
beloved	Positiv
true	Positiv
passion	EMOT
suit	Legal
spite	Negativ
hatred	Negativ
favor	Positiv
impartial	Positiv
involvement	Arousal
expectation	Arousal
enjoyment	Positiv
creative	Exprsv
faith	Relig
sick	Negativ
heartless	Negativ
ferocious	Negativ
shameless	Negativ
hopeful	Positiv
courage	Positiv
warmth	Positiv
enrage	Negativ
haughty	Negativ
certain	Virtue
interest	Econ@
admirer	Positiv
coolness	Negativ
scornful	Negativ
fickle	Negativ
aggressive	Negativ
scorn	Negativ
doubt	Negativ
indifferent	Negativ
controversy	Negativ
religious	Relig
gall	Negativ
desolation	Negativ
spiteful	Negativ
solemn	Relig
compassion	Positiv
motivated	Positiv
callous	Negativ
crazy	Negativ
almighty	Positiv
alienation	Negativ
mix	Negativ
contempt	Negativ
fierce	Negativ
collect	Virtue
long	EMOT
curiosity	EMOT
wish	EMOT
desire	Negativ
curious	EMOT
cocky	Negativ
compassionate	Positiv
moody	Negativ
friendly	Positiv
detest	Negativ
actuality	Positiv
harmony	Positiv
autonomy	Virtue
suitable	Positiv
undoubted	Positiv
fancy	Positiv
healthy	Positiv
potential	Virtue
simplify	Positiv
respectful	Positiv
vivacious	Positiv
adept	Positiv
mercy	Positiv
salutary	Positiv
dignity	Positiv
noteworthy	Virtue
must	Virtue
loyalty	Polit@
magnificence	Positiv
responsibility	Positiv
promise	Positiv
modernization	Virtue
amiable	Positiv
heroic	Positiv
remarkable	Positiv
courtly	Polit@
magnificent	Positiv
protection	Positiv
selective	Positiv
reliability	Positiv
assist	Positiv
shrewd	Positiv
persistent	Virtue
objective	Positiv
authentic	Positiv
harmless	Positiv
prove	Virtue
cooperation	Positiv
good	Positiv
profound	Positiv
absolute	Virtue
decency	Positiv
consistent	Positiv
qualify	Positiv
prosperity	Positiv
valuable	Econ@
sincerity	Positiv
beneficial	Positiv
support	Positiv
treasure	Econ@
favorable	Positiv
charity	Econ@
modest	Positiv
likable	Positiv
positive	Positiv
popularity	Positiv
obligation	Virtue
rich	Econ@
shrewdness	Positiv
tolerance	Positiv
priceless	Econ@
allure	Positiv
assistance	Positiv
evaluation	Virtue
liberal	Academ
road	Polit@
splendid	Positiv
handsome	Positiv
experience	Positiv
superlative	Positiv
benevolent	Econ@
prudent	Positiv
wise	Academ
allegiance	Positiv
providence	Relig
valor	Positiv
renown	Positiv
resourceful	Positiv
sensational	Positiv
commitment	Positiv
economical	Econ@
unimpeachable	Polit@
potentiality	Virtue
taste	Exprsv
stupendous	Positiv
accurate	Positiv
affability	Positiv
contemplation	Virtue
amenable	Positiv
moral	Positiv
easy	Positiv
patience	Positiv
efficiency	Positiv
refine	Positiv
diligent	Positiv
accustom	Virtue
pious	Relig
civility	Positiv
regal	Positiv
competent	Positiv
versatile	Positiv
fortunate	Positiv
hospitable	Positiv
impressive	Positiv
overture	Virtue
thoughtful	Positiv
legitimate	Legal
wealthy	Econ@
availability	Positiv
kind	Positiv
tolerant	Positiv
lucky	Positiv
stately	Positiv
boldness	Positiv
super	Positiv
bonny	Positiv
chosen	Positiv
grace	Relig
spare	Positiv
toleration	Positiv
trustworthiness	Positiv
constructive	Positiv
acceptable	Positiv
hardy	Positiv
talented	Positiv
correct	Positiv
courageous	Positiv
prudence	Positiv
amicable	Positiv
funny	Positiv
adequate	Positiv
decisive	Virtue
beauty	Positiv
practical	Positiv
cherub	Positiv
guidance	Virtue
careful	Positiv
valid	Positiv
behalf	Positiv
strenuous	Virtue
altruistic	Positiv
apt	Positiv
invincible	Positiv
affinity	Positiv
fortitude	Positiv
round	Positiv
educated	Academ
freedom	Polit@
vital	Virtue
fine	Econ@
simplicity	Positiv
heroism	Positiv
sumptuous	Positiv
infallibility	Positiv
amiability	Positiv
gentle	Positiv
dedication	Positiv
proper	Positiv
reward	Econ@
significance	Positiv
perfect	Positiv
emancipation	Polit@
efficient	Positiv
opportune	Positiv
reasonable	Positiv
might	Polit@
sound	Positiv
culture	Positiv
available	Virtue
generosity	Econ@
power	Polit@
favorite	Positiv
propitious	Positiv
common	Econ@
strength	Virtue
basic	Positiv
darling	Positiv
enchant	Positiv
capable	Positiv
usable	Positiv
acclamation	Positiv
adroitly	Positiv
spectacular	Positiv
worthy	Positiv
suave	Positiv
humble	Positiv
train	Positiv
significant	Positiv
elegance	Positiv
exact	Positiv
cut	Negativ
pertinent	Positiv
resplendent	Positiv
handy	Positiv
truthful	Positiv
virtue	Positiv
wit	Virtue
able	Positiv
premium	Positiv
reliable	Positiv
reform	Polit@
privilege	Virtue
earth	Virtue
safety	Positiv
accuracy	Positiv
affable	Positiv
justifiably	Positiv
conviction	Positiv
treat	Positiv
respectable	Positiv
spotless	Positiv
undoubtedly	Positiv
clever	Positiv
victorious	Positiv
compatible	Positiv
charm	Positiv
bold	Virtue
eminent	Positiv
advantageous	Positiv
punctual	Positiv
moderate	Positiv
terrific	Positiv
encourage	Positiv
efficacy	Positiv
tremendous	Positiv
right	Legal
congenial	Positiv
courtesy	Positiv
control	Virtue
responsible	Positiv
exceptional	Virtue
composure	Positiv
dynamic	Positiv
demand	Vice
tact	Positiv
sanitary	Positiv
health	Positiv
accurateness	Positiv
astute	Positiv
adaptable	Positiv
gallant	Positiv
rare	Virtue
faithful	Relig
profitable	Econ@
spiritual	Relig
mint	Positiv
bravery	Positiv
democracy	Polit@
collaboration	Positiv
discretion	Positiv
justification	Positiv
open	Positiv
superiority	Positiv
truth	Positiv
conscientious	Positiv
meritorious	Econ@
perseverance	Positiv
alertness	Positiv
convenience	Virtue
luxury	Econ@
peace	Positiv
sacred	Relig
prominent	Positiv
fluent	Positiv
productive	Econ@
soundness	Positiv
pretty	Positiv
healthful	Positiv
merit	Positiv
sufficient	Positiv
veritable	Positiv
attractive	Positiv
actual	Positiv
famous	Positiv
gifted	Positiv
normal	Positiv
rather	Virtue
rational	Academ
vigor	Virtue
cultivate	Positiv
progressive	Positiv
condition	Virtue
foremost	Positiv
influential	Virtue
desirable	Positiv
adult	Positiv
politeness	Positiv
immaculate	Positiv
conscience	Positiv
agility	Positiv
athletic	Exprsv
dedicate	Positiv
improvement	Positiv
dear	Positiv
greatness	Positiv
due	Econ@
doubtless	Positiv
equality	Polit@
palatable	Positiv
fantastic	Positiv
stylish	Positiv
venerable	Positiv
loyal	Polit@
effectiveness	Positiv
encouragement	Positiv
compensation	Positiv
alight	Positiv
solidarity	Virtue
eligible	Virtue
sophisticated	Positiv
smash	Negativ
promptly	Positiv
pure	Positiv
fit	Positiv
discreet	Positiv
reputable	Positiv
supply	Econ@
thoughtfulness	Positiv
consistency	Positiv
popular	Positiv
thorough	Positiv
prime	Positiv
blameless	Legal
foresight	Positiv
conformity	Virtue
divinity	Relig
cautious	Virtue
competitive	Negativ
intellectual	Academ
resourcefulness	Positiv
wholesome	Positiv
vitality	Positiv
purity	Positiv
pinnacle	Positiv
splendor	Positiv
graceful	Positiv
just	Legal
straight	Positiv
organize	Positiv
adjustment	Positiv
salvation	Relig
fortune	Econ@
board	Academ
charitable	Econ@
loveliness	Positiv
real	Econ@
undaunted	Virtue
better	Positiv
intellect	Academ
innocence	Positiv
supremacy	Virtue
eloquent	Exprsv
elegant	Positiv
competence	Positiv
quality	Positiv
kindness	Positiv
wisdom	Academ
casual	Positiv
majestic	Positiv
helpful	Positiv
supernatural	Relig
progress	Positiv
integrity	Positiv
ideal	Positiv
share	Positiv
grand	Positiv
sure	Virtue
noble	Positiv
outstanding	Positiv
buy	Econ@
godliness	Positiv
establish	Positiv
grown	Virtue
adjust	Positiv
authoritative	Legal
indisputable	Virtue
coordination	Positiv
surplus	Econ@
worth	Econ@
fellowship	Positiv
gracious	Positiv
clean	Positiv
humanitarian	Polit@
imaginative	Exprsv
best	Positiv
benign	Positiv
peaceful	Positiv
frank	Positiv
dependable	Positiv
service	Milit
leisure	Exprsv
lawful	Legal
bless	Relig
effective	Positiv
generous	Positiv
sport	Exprsv
honor	Positiv
beneficent	Positiv
acclaim	Positiv
angel	Relig
neat	Positiv
ambition	Virtue
exclusive	Virtue
capital	Econ@
merciful	Positiv
duty	Negativ
expert	Positiv
purification	Positiv
distinguish	Positiv
benefactor	Econ@
convenient	Virtue
miracle	Relig
essential	Positiv
subtle	Positiv
special	Positiv
fair	Exprsv
suffrage	Polit@
honest	Positiv
satisfactory	Positiv
aptitude	Positiv
rescue	Positiv
important	Positiv
adaptability	Positiv
humility	Positiv
influence	Virtue
nice	Positiv
supreme	Legal
scrupulous	Positiv
opportunity	Positiv
advantage	Positiv
beacon	Positiv
sweet	Positiv
aid	Positiv
palatial	Positiv
luck	Positiv
hit	Negativ
invite	Positiv
trustworthy	Positiv
decent	Positiv
mature	Positiv
adroit	Positiv
ingenious	Positiv
unselfish	Positiv
cooperative	Econ@
valiant	Positiv
adaptation	Positiv
angelic	Relig
ethical	Positiv
lovely	Positiv
daring	Positiv
help	Negativ
versatility	Positiv
baby	Econ@
solace	Positiv
workable	Positiv
adaptive	Positiv
learn	Academ
excellent	Positiv
busy	Virtue
understandable	Positiv
honorable	Positiv
powerful	Polit@
indispensability	Positiv
unbroken	Positiv
virtuous	Positiv
innocent	Legal
extraordinary	Positiv
plausible	Virtue
vigorous	Virtue
benevolence	Econ@
admirable	Positiv
luckily	Positiv
quaint	Positiv
accolade	Positiv
chivalry	Positiv
majesty	Positiv
ball	Exprsv
spontaneous	Virtue
genuine	Positiv
conventional	Virtue
cover	Virtue
courteous	Positiv
divine	Relig
adornment	Positiv
invulnerable	Positiv
well	Positiv
improve	Positiv
viable	Positiv
ambitious	Virtue
untouched	Positiv
superior	Positiv
use	Econ@
enlighten	Positiv
goodness	Positiv
inspire	Positiv
fruitful	Positiv
safe	Positiv
advance	Positiv
appropriate	Positiv
agile	Positiv
purify	Positiv
security	Econ@
cherish	Positiv
excellence	Positiv
authenticity	Positiv
independent	Polit@
miraculous	Relig
forgiveness	Positiv
lot	Virtue
infallible	Positiv
keen	Positiv
polite	Positiv
own	Econ@
preferably	Virtue
skill	Positiv
useful	Positiv
paramount	Positiv
brave	Positiv
cute	Positiv
holy	Relig
meaningful	Positiv
ability	Positiv
flair	Positiv
note	Virtue
precision	Positiv
credit	Academ
typical	Virtue
accommodation	Positiv
principle	Legal
satisfactorily	Positiv
validity	Positiv
prestige	Positiv
prettily	Positiv
flawless	Positiv
glorious	Positiv
adorable	Positiv
legitimacy	Legal
sensible	Positiv
productivity	Econ@
cordial	Positiv
sane	Positiv
chaste	Positiv
completeness	Positiv
deep	Virtue
approve	Positiv
friendship	Positiv
usefulness	Positiv
free	Positiv
fairness	Positiv
patient	Positiv
considerate	Positiv
accessible	Positiv
lead	Positiv
practicable	Positiv
marvelous	Positiv
start	Virtue
gallantry	Positiv
skillful	Positiv
unity	Positiv
brotherhood	Positiv
chivalrous	Positiv
standard	Virtue
heavenly	Relig
discipline	Virtue
precise	Positiv
glory	Positiv
intelligent	Positiv
perfection	Positiv
cleanliness	Positiv
prompt	Positiv
arrest	Legal
take	Virtue
wonderful	Positiv
refinement	Positiv
precious	Econ@
manly	Positiv
sincere	Positiv
enjoyable	Positiv
stability	Positiv
sociable	Positiv
faithfulness	Positiv
intelligence	Academ
mighty	Positiv
commendable	Positiv
remarkably	Positiv
talent	Positiv
return	Econ@
equitable	Positiv
character	Exprsv
litter	Negativ
vain	Negativ
awkward	Negativ
cynicism	Negativ
disease	Negativ
refuse	Negativ
vulgar	Negativ
queer	Negativ
ignoble	Negativ
accursed	Negativ
cruelty	Negativ
absentee	Negativ
damage	Negativ
bother	Negativ
defective	Negativ
incompatible	Negativ
nuisance	Negativ
arbitrary	Negativ
adulteration	Negativ
unprepared	Vice
useless	Negativ
suicide	Vice
lunatic	Negativ
improper	Negativ
fix	Negativ
forgetfulness	Negativ
dreary	Negativ
crafty	Negativ
unattractive	Negativ
obnoxious	Negativ
defiant	Negativ
infringement	Legal
manslaughter	Legal
reprehensible	Negativ
insignificant	Negativ
confrontation	Negativ
mar	Negativ
weird	Negativ
envious	Negativ
pervert	Negativ
symptom	Negativ
unimportant	Negativ
aggravation	Negativ
disadvantageous	Negativ
flu	Vice
deceit	Negativ
dope	Negativ
brutality	Negativ
instability	Negativ
extravagant	Econ@
guilty	Legal
perverse	Negativ
void	Negativ
deficit	Econ@
offensive	Negativ
stubborn	Negativ
grim	Negativ
defiance	Negativ
stupid	Negativ
crisis	Negativ
resistance	Vice
poor	Econ@
pollution	Negativ
harm	Negativ
tyranny	Polit@
disapproval	Negativ
immorality	Negativ
unwise	Negativ
dissention	Negativ
idle	Vice
desolate	Negativ
strict	Negativ
outrageous	Negativ
culprit	Negativ
agitation	Negativ
domination	Negativ
adverse	Negativ
tedious	Negativ
disturbance	Negativ
short	Negativ
unfair	Negativ
careless	Negativ
drunkard	Negativ
danger	Negativ
negative	Negativ
bleak	Negativ
crime	Legal
hideous	Negativ
destructive	Negativ
imperfect	Negativ
inhibition	Negativ
unclean	Negativ
deplorable	Negativ
menace	Negativ
delirium	Negativ
expensive	Econ@
sly	Negativ
tragic	Negativ
chaotic	Negativ
crook	Negativ
barbarian	Negativ
indecisive	Vice
unfriendly	Negativ
complication	Negativ
notorious	Negativ
unjust	Legal
scoundrel	Negativ
bribe	Econ@
unreliable	Negativ
harmful	Negativ
crash	Vice
violent	Negativ
burglary	Negativ
violation	Legal
confuse	Negativ
chaos	Negativ
waste	Econ@
misbehavior	Negativ
blame	Negativ
head	Academ
treacherous	Negativ
delusion	Negativ
infamous	Negativ
dunce	Negativ
lack	Negativ
oversight	Negativ
formidable	Negativ
hack	Negativ
withdrawn	Vice
slothful	Negativ
deception	Negativ
deadly	Negativ
unsatisfactory	Negativ
bound	Negativ
stick	Negativ
bogus	Negativ
terrible	Negativ
blockhead	Negativ
condescending	Negativ
damnable	Negativ
mistake	Negativ
adultery	Negativ
inability	Negativ
troublesome	Negativ
unsoundness	Vice
redundancy	Negativ
infiltration	Negativ
delinquent	Negativ
cold	Polit@
distraction	Negativ
horn	Exprsv
conceit	Negativ
unsound	Negativ
sin	Relig
cynical	Negativ
indecent	Negativ
unfortunate	Negativ
disastrous	Negativ
fabrication	Negativ
difficulty	Negativ
untrustworthy	Negativ
odd	Negativ
shaggy	Negativ
hesitation	Vice
consumptive	Negativ
worst	Negativ
abominable	Negativ
steal	Legal
impurity	Negativ
redundant	Negativ
crooked	Negativ
hole	Econ@
unpopular	Negativ
avaricious	Negativ
covert	Negativ
madness	Negativ
pinch	Negativ
double	Negativ
precarious	Negativ
misuse	Negativ
puny	Negativ
stigma	Negativ
unemployed	Econ@
inaccessible	Negativ
recalcitrant	Negativ
shady	Negativ
unworthy	Negativ
too	Negativ
foreign	Negativ
cannibal	Negativ
ignorant	Negativ
negation	Negativ
assault	Negativ
craziness	Negativ
deadweight	Negativ
unsure	Vice
irresponsible	Negativ
bane	Negativ
capricious	Negativ
boredom	Negativ
monotony	Negativ
damned	Negativ
wound	Negativ
abuse	Negativ
filth	Negativ
recklessness	Negativ
failure	Negativ
idleness	Negativ
craze	Negativ
weakness	Vice
stolen	Legal
unreliability	Negativ
coercion	Negativ
discrimination	Vice
strike	Econ@
defeat	Negativ
insidious	Negativ
avarice	Negativ
deaf	Negativ
unlucky	Negativ
ignorance	Negativ
devastation	Negativ
stuffy	Negativ
confusion	Negativ
fracture	Negativ
aghast	Negativ
brutish	Negativ
detrimental	Negativ
clutter	Negativ
rude	Negativ
awkwardness	Negativ
rigorous	Negativ
drab	Negativ
shortcoming	Negativ
threat	Negativ
arrogance	Negativ
wrong	Negativ
unfaithful	Negativ
dismal	Negativ
injury	Negativ
undesirable	Negativ
primitive	Vice
arduous	Negativ
skeptical	Negativ
abject	Negativ
undue	Negativ
impulsive	Negativ
unmitigated	Vice
disruption	Negativ
grave	Relig
indefinite	Negativ
abnormal	Negativ
blind	Negativ
sloth	Negativ
misfortune	Negativ
sluggish	Negativ
monotonous	Negativ
horrid	Negativ
bow	Milit
murder	Negativ
fanatic	Negativ
trauma	Negativ
unreal	Vice
animosity	Negativ
ragged	Vice
backwardness	Negativ
rejection	Negativ
insane	Negativ
peculiar	Negativ
hazardous	Negativ
creep	Vice
loveless	Negativ
instable	Negativ
vulnerability	Vice
dirty	Negativ
disputable	Legal
vulnerable	Vice
defect	Negativ
indecision	Vice
deafness	Negativ
dreadful	Negativ
negligence	Legal
worn	Negativ
petty	Negativ
plague	Negativ
uncouth	Negativ
disgrace	Negativ
selfish	Negativ
contemptuous	Negativ
busybody	Negativ
dilemma	Negativ
drunk	Negativ
dominant	Vice
foolishness	Negativ
mean	Negativ
superficiality	Negativ
undependable	Negativ
scum	Negativ
catch	Negativ
egotistical	Negativ
aggression	Negativ
strife	Negativ
hypocrisy	Negativ
impatient	Negativ
wrongful	Negativ
despicable	Negativ
crass	Negativ
counterfeit	Negativ
rampant	Negativ
beastly	Negativ
hesitant	Vice
cancer	Negativ
penalty	Legal
artificial	Negativ
slug	Negativ
bore	Negativ
meaningless	Negativ
incorrect	Negativ
affectation	Negativ
divorce	Legal
unnecessary	Negativ
unrest	Negativ
fever	Negativ
restrict	Negativ
ironic	Negativ
dubious	Negativ
dangerous	Negativ
affliction	Negativ
timid	Vice
hindrance	Negativ
pretentious	Negativ
filthy	Negativ
bankruptcy	Econ@
excessive	Negativ
sickness	Negativ
dire	Negativ
condemnation	Negativ
bizarre	Negativ
beside	Vice
radical	Polit@
confinement	Negativ
deceive	Negativ
involve	Negativ
bothersome	Negativ
trick	Negativ
worse	Negativ
appall	Negativ
delinquency	Negativ
blindness	Negativ
fanatical	Negativ
stunt	Negativ
horrible	Negativ
inhumane	Negativ
insecure	Negativ
impediment	Negativ
wear	Negativ
cheater	Negativ
inane	Negativ
limitation	Negativ
boast	Negativ
contamination	Negativ
false	Negativ
spot	Negativ
hazard	Negativ
broke	Econ@
severe	Negativ
futility	Negativ
dissent	Negativ
illness	Negativ
discouragement	Negativ
equivocal	Negativ
vice	Legal
demon	Negativ
clumsy	Negativ
ingratitude	Negativ
relentless	Vice
envy	Negativ
badly	Negativ
poverty	Econ@
frail	Vice
complicity	Negativ
beat	Exprsv
fight	Milit
rotten	Negativ
discord	Negativ
unfamiliar	Negativ
unscrupulous	Negativ
annihilation	Negativ
harsh	Negativ
hardship	Negativ
desertion	Negativ
mess	Negativ
drunken	Negativ
unstable	Negativ
feeble	Negativ
predicament	Negativ
sickly	Negativ
unfavorable	Negativ
commotion	Negativ
static	Negativ
brat	Negativ
intervention	Milit
decadent	Negativ
detachment	Negativ
brute	Negativ
whip	Negativ
unkind	Negativ
disobedient	Negativ
evil	Negativ
grotesque	Negativ
cursory	Negativ
timidity	Negativ
unsuccessful	Negativ
consternation	Negativ
severity	Negativ
unjustified	Negativ
repugnant	Negativ
negligent	Legal
sinister	Negativ
audacious	Negativ
vile	Negativ
corrupt	Econ@
illegal	Legal
disaster	Negativ
rash	Negativ
carelessness	Negativ
doom	Negativ
silly	Negativ
fail	Negativ
immoral	Negativ
dependence	Vice
unpleasant	Negativ
helplessness	Negativ
foolish	Negativ
bondage	Negativ
temptation	Negativ
incapable	Negativ
rascal	Negativ
disorganized	Negativ
ugly	Negativ
condescension	Negativ
bereavement	Negativ
cheap	Econ@
avenge	Negativ
havoc	Negativ
stale	Negativ
coarseness	Negativ
arrogant	Negativ
derision	Negativ
idiot	Negativ
deficiency	Negativ
difficult	Negativ
unqualified	Negativ
awful	Negativ
worthless	Negativ
degenerate	Negativ
confiscation	Negativ
corruption	Negativ
unauthentic	Negativ
manner	Vice
deceitful	Negativ
disadvantage	Negativ
homely	Negativ
irrational	Negativ
perilous	Negativ
sketchy	Negativ
shoot	Exprsv
disobedience	Negativ
impetuous	Negativ
pest	Negativ
decadence	Negativ
unable	Vice
cruel	Negativ
prohibitive	Negativ
deficient	Negativ
aggressiveness	Negativ
illegality	Legal
unemployment	Econ@
detestable	Negativ
catastrophe	Negativ
untrue	Negativ
preposterous	Negativ
liquidation	Econ@
naive	Negativ
ridiculous	Negativ
mundane	Negativ
wastefulness	Negativ
injurious	Negativ
audacity	Negativ
idiotic	Negativ
burglar	Negativ
hypocrite	Negativ
rupture	Negativ
derisive	Negativ
risky	Negativ
tiresome	Negativ
destruction	Negativ
undignified	Negativ
superficial	Negativ
blemish	Negativ
roundabout	Negativ
adversity	Negativ
sort	Negativ
study	Academ
unexpectedly	Negativ
atrocious	Negativ
alarming	Negativ
incompatibility	Negativ
fruitless	Negativ
stupidity	Negativ
limit	Negativ
embarrassment	Negativ
ruin	Negativ
monstrous	Negativ
hapless	Negativ
diseased	Negativ
front	Negativ
unclear	Negativ
carry	Vice
absurdity	Negativ
disdain	Negativ
interference	Negativ
unbelievable	Negativ
fault	Negativ
insecurity	Negativ
ominous	Negativ
painful	Negativ
inferior	Negativ
attack	Negativ
hectic	Negativ
matter	Negativ
vanity	Negativ
questionable	Negativ
banal	Negativ
ordeal	Negativ
violence	Negativ
ghastly	Negativ
impersonal	Negativ
depraved	Negativ
wrinkle	Negativ
wrought	Negativ
rat	Negativ
force	Milit
impure	Negativ
serve	Econ@
turmoil	Negativ
sour	Negativ
loss	Negativ
bankrupt	Econ@
inadequate	Negativ
invalid	Negativ
nonsense	Negativ
bad	Negativ
lost	Negativ
inexact	Negativ
vicious	Negativ
chronic	Negativ
circle	Negativ
emergency	Negativ
unfit	Negativ
amiss	Negativ
contemptible	Negativ
repulsive	Negativ
venom	Negativ
disorder	Negativ
butchery	Negativ
burden	Negativ
presumptuous	Negativ
fussy	Negativ
barbarous	Negativ
roughness	Negativ
burn	Negativ
load	Negativ
costly	Econ@
boastful	Negativ
headache	Negativ
insufficient	Negativ
madman	Negativ
reckless	Negativ
ruinous	Negativ
unchecked	Vice
hand	Negativ
sunburn	Vice
childish	Negativ
error	Negativ
irony	Negativ
doubtful	Negativ
lazy	Negativ
wasteful	Negativ
dearth	Negativ
ludicrous	Negativ
particular	Negativ
ungrateful	Negativ
handicap	Negativ
absurd	Negativ
regression	Negativ
clarity	Positiv
righteousness	Positiv
morality	Positiv
flatter	Positiv
successful	Positiv
captivation	Positiv
realistically	Positiv
betrothal	Econ@
deference	Positiv
necessarily	Positiv
friend	Positiv
distinct	Positiv
multitude	Positiv
soothe	Positiv
abound	Positiv
achievement	Positiv
coax	Positiv
lucrative	Econ@
chic	Positiv
comely	Positiv
subscription	Positiv
idealism	Positiv
civilize	Positiv
acceptance	Positiv
obedient	Positiv
alive	Positiv
precept	Positiv
prosper	Econ@
symbolize	Positiv
hallowed	Positiv
modernity	Positiv
communal	Positiv
ensemble	Positiv
conducive	Positiv
endorse	Positiv
communicate	Positiv
prosecute	Legal
reverence	Positiv
woo	Positiv
persuasive	Positiv
approval	Positiv
distinction	Positiv
painstaking	Positiv
subscribe	Positiv
education	Academ
accordance	Positiv
melody	Exprsv
donation	Econ@
interested	Positiv
obtainable	Positiv
protect	Positiv
commodious	Positiv
indicative	Positiv
purposeful	Positiv
commonsense	Positiv
humanity	Positiv
masterful	Positiv
subsist	Positiv
scamper	Positiv
cure	Positiv
commencement	Positiv
befitting	Positiv
meet	Positiv
rehabilitation	Positiv
durable	Positiv
exultation	Positiv
golden	Positiv
warm	Positiv
surpass	Positiv
jointly	Positiv
gift	Positiv
avid	Positiv
attentive	Positiv
assent	Positiv
breadwinner	Econ@
vivid	Positiv
amplify	Positiv
rapture	Positiv
ceremonial	Positiv
flaunt	Positiv
surge	Positiv
plain	Positiv
consummate	Positiv
flexible	Positiv
foster	Positiv
attendance	Positiv
radiate	Positiv
inventor	Positiv
conjunction	Positiv
enhancement	Positiv
studious	Positiv
overcome	Positiv
constancy	Positiv
posterity	Positiv
unhurried	Positiv
premise	Positiv
protective	Positiv
aristocracy	Econ@
formality	Positiv
longevity	Positiv
subsidy	Econ@
accomplishment	Positiv
mobility	Positiv
uttermost	Positiv
contact	Positiv
resound	Positiv
upheld	Legal
garnish	Positiv
abundance	Positiv
perfectionist	Positiv
mastery	Positiv
chum	Positiv
glow	Positiv
staunch	Positiv
obedience	Positiv
forward	Positiv
home	Positiv
enlightenment	Positiv
fellow	Positiv
remedy	Positiv
luminous	Positiv
fidelity	Positiv
suffice	Positiv
momentous	Positiv
savings	Econ@
allowance	Econ@
reassurance	Positiv
sober	Positiv
concession	Positiv
console	Positiv
zenith	Positiv
prosperous	Econ@
amenity	Positiv
attractiveness	Positiv
instinctive	Positiv
correction	Positiv
accountable	Positiv
kiss	Positiv
sprightly	Positiv
tactics	Polit@
temperance	Positiv
nobleman	Econ@
abundant	Positiv
irresistible	Positiv
cognizance	Positiv
embellish	Positiv
steadfastness	Positiv
survival	Positiv
confer	Positiv
counsel	Legal
minister	Relig
illuminate	Positiv
tradition	Positiv
pass	Legal
durability	Positiv
acquaintance	Positiv
magnetic	Positiv
compliance	Positiv
aspiration	Positiv
proficient	Positiv
consultation	Positiv
utilize	Positiv
hero	Positiv
marvel	Positiv
intercede	Positiv
empower	Positiv
firmness	Positiv
shiny	Positiv
poignant	Positiv
energetic	Positiv
plaything	Positiv
aristocrat	Econ@
togetherness	Positiv
educational	Academ
assurance	Positiv
comprehension	Positiv
liberate	Positiv
boom	Econ@
eye	Legal
accomplish	Positiv
caress	Positiv
proffer	Positiv
interpose	Positiv
unlimited	Positiv
realistic	Positiv
marriage	Positiv
adorn	Positiv
forgave	Positiv
blossom	Positiv
compromise	Positiv
lucid	Positiv
complete	Positiv
vastness	Positiv
adhesion	Positiv
community	Positiv
stable	Positiv
commendation	Positiv
contribute	Econ@
independence	Polit@
natural	Positiv
monumental	Positiv
conqueror	Positiv
rally	Polit@
backer	Econ@
renaissance	Positiv
descry	Positiv
deserve	Positiv
propriety	Positiv
uppermost	Positiv
championship	Positiv
logical	Positiv
factual	Positiv
befriend	Positiv
backbone	Positiv
liberty	Polit@
grandeur	Positiv
haven	Positiv
exult	Positiv
bolster	Positiv
congregate	Positiv
oasis	Relig
learner	Academ
receptive	Positiv
luxurious	Positiv
civilization	Positiv
fulfill	Positiv
coexistence	Positiv
connect	Positiv
coherent	Positiv
nobility	Econ@
boundless	Positiv
culminate	Positiv
ample	Positiv
capitalize	Econ@
lustrous	Positiv
arbiter	Positiv
flashy	Positiv
glimmer	Positiv
inexpensive	Econ@
festival	Positiv
stimulate	Positiv
communion	Relig
fortify	Positiv
fabulous	Positiv
provide	Positiv
endurance	Positiv
graduation	Academ
potency	Positiv
append	Positiv
affiliate	Positiv
perfume	Positiv
compliment	Positiv
allies	Positiv
call	Positiv
outwit	Positiv
sage	Positiv
fame	Positiv
marry	Positiv
staunchness	Positiv
consult	Positiv
accentuate	Positiv
populous	Positiv
redeem	Positiv
substantiate	Positiv
live	Econ@
know	Positiv
partnership	Econ@
insight	Positiv
lyric	Exprsv
prance	Positiv
adjunct	Positiv
everlasting	Positiv
endow	Econ@
accrue	Econ@
enrichment	Positiv
nominate	Polit@
standardize	Positiv
laudable	Positiv
visionary	Positiv
art	Academ
clarify	Positiv
condone	Positiv
fill	Econ@
playmate	Positiv
extol	Positiv
privileged	Econ@
bright	Positiv
thrifty	Econ@
ameliorate	Positiv
farsighted	Positiv
amazing	Positiv
revelation	Positiv
revere	Positiv
glamour	Positiv
distinguished	Positiv
distinctive	Positiv
mentor	Positiv
polish	Positiv
saint	Relig
eminence	Positiv
make	Negativ
joke	Exprsv
survive	Positiv
gusto	Positiv
inseparable	Positiv
comedy	Exprsv
negotiate	Positiv
consign	Positiv
forgive	Positiv
absolve	Positiv
dig	Positiv
pro	Positiv
pleasantry	Positiv
main	Positiv
reparation	Positiv
ardent	Positiv
defense	Positiv
enrich	Positiv
staple	Positiv
champ	Positiv
reconciliation	Positiv
bequeath	Econ@
preparatory	Positiv
synthesis	Positiv
softness	Positiv
adventurous	Positiv
renovation	Positiv
infer	Positiv
join	Positiv
nurture	Positiv
repentance	Positiv
illustrious	Positiv
guarantee	Legal
travel	Positiv
enable	Positiv
reclaim	Positiv
unique	Positiv
congratulation	Positiv
kid	Exprsv
intelligible	Positiv
patriotic	Polit@
arisen	Positiv
nourish	Positiv
comprehensive	Positiv
confide	Positiv
afloat	Econ@
nourishment	Positiv
motivation	Positiv
reestablish	Positiv
tranquil	Positiv
sought	Positiv
genius	Positiv
immortal	Positiv
consider	Positiv
achieve	Positiv
mild	Positiv
tolerate	Positiv
permit	Legal
protector	Positiv
picturesque	Positiv
accord	Positiv
agreement	Positiv
human	Positiv
coddle	Positiv
buoyant	Positiv
righteous	Positiv
inauguration	Positiv
gold	Econ@
great	Positiv
assistant	Positiv
pomp	Positiv
strut	Positiv
betroth	Econ@
profess	Positiv
abide	Positiv
alliance	Polit@
baptism	Positiv
cleanse	Positiv
outright	Positiv
discuss	Positiv
honeymoon	Positiv
light	Positiv
adhesive	Positiv
safeguard	Positiv
consolidate	Positiv
cheer	Positiv
allowable	Positiv
playful	Positiv
ascribe	Positiv
accede	Positiv
accept	Positiv
praise	Positiv
peerless	Positiv
anoint	Positiv
familiarize	Positiv
onset	Positiv
cogent	Positiv
reverently	Positiv
solution	Positiv
convene	Positiv
association	Positiv
stand	Positiv
consensus	Positiv
confederation	Polit@
greet	Positiv
privy	Positiv
welfare	Econ@
covenant	Positiv
precedent	Legal
prize	Positiv
relevance	Positiv
inherit	Econ@
mobilize	Positiv
gorgeous	Positiv
laugh	Exprsv
sanctuary	Positiv
indescribable	Positiv
surmise	Positiv
impervious	Positiv
pay	Econ@
radiant	Positiv
excel	Positiv
unbound	Positiv
compensate	Econ@
confidant	Positiv
semblance	Positiv
legal	Legal
cohesion	Positiv
ripen	Positiv
flourish	Positiv
visualization	Positiv
surmount	Positiv
scruples	Positiv
forgiven	Positiv
dexterity	Positiv
commensurate	Positiv
individuality	Positiv
etiquette	Positiv
treaty	Polit@
tribute	Positiv
conquer	Positiv
reunion	Positiv
patron	Econ@
guardian	Positiv
asset	Positiv
understood	Positiv
heal	Positiv
impress	Positiv
plentiful	Positiv
donate	Econ@
uphold	Legal
recompense	Econ@
prominence	Positiv
noiseless	Positiv
save	Econ@
obtain	Positiv
sweetheart	Positiv
apprehend	Positiv
steadfast	Positiv
colleague	Positiv
brotherly	Positiv
importance	Positiv
venerate	Positiv
workmanship	Positiv
marital	Positiv
quicken	Positiv
celebration	Positiv
candor	Positiv
thrift	Econ@
glitter	Positiv
culmination	Positiv
stimulation	Positiv
contributor	Positiv
celebrity	Positiv
accompaniment	Positiv
steadiness	Positiv
navigable	Positiv
credibility	Positiv
lyrical	Exprsv
mend	Positiv
manageable	Positiv
utilization	Positiv
allied	Polit@
nimble	Positiv
glisten	Positiv
readily	Positiv
knowledge	Academ
clear	Econ@
acquittal	Legal
ethics	Positiv
advancement	Positiv
premier	Positiv
convince	Positiv
aspire	Positiv
inform	Positiv
completion	Positiv
persevere	Positiv
onward	Positiv
engage	Positiv
congratulatory	Positiv
cooperate	Positiv
exertion	Positiv
allow	Positiv
fruition	Positiv
welcome	Positiv
primarily	Positiv
heartily	Positiv
commemoration	Positiv
coordinate	Positiv
succeed	Positiv
lover	Positiv
delicacy	Positiv
acquit	Legal
upward	Positiv
curtsey	Positiv
amazement	Positiv
vanquish	Positiv
indispensable	Positiv
thank	Positiv
delicate	Positiv
comeback	Positiv
lifelong	Positiv
accession	Positiv
originality	Positiv
motive	Positiv
affirmation	Positiv
adjustable	Positiv
affluent	Econ@
sparkle	Positiv
elaboration	Positiv
trophy	Positiv
redemption	Positiv
repair	Positiv
fearless	Positiv
treatise	Legal
paradise	Relig
utilitarian	Positiv
verification	Positiv
prolific	Positiv
attend	Positiv
innovate	Positiv
prodigious	Positiv
audible	Positiv
robust	Positiv
comprehend	Positiv
signify	Positiv
filial	Positiv
feast	Positiv
beneficiary	Econ@
meticulous	Positiv
radiance	Positiv
affirmative	Positiv
patriot	Polit@
baptize	Positiv
equity	Econ@
defender	Positiv
idol	Positiv
verify	Positiv
plausibility	Positiv
upside	Positiv
squarely	Positiv
relevancy	Positiv
glean	Positiv
niche	Positiv
extravagance	Positiv
exalt	Positiv
conjure	Exprsv
heaven	Relig
companionship	Positiv
council	Polit@
portable	Positiv
repent	Positiv
subsistence	Positiv
symmetry	Positiv
deservedly	Positiv
ally	Polit@
harness	Positiv
tempt	Positiv
notable	Positiv
dignify	Positiv
flattery	Positiv
glamorous	Positiv
oblige	Positiv
magical	Relig
absorbent	Positiv
guide	Econ@
feasible	Positiv
benefit	Econ@
obey	Positiv
summit	Positiv
exotic	Positiv
bestow	Positiv
thankful	Positiv
novelty	Positiv
prowess	Positiv
appreciable	Positiv
deduce	Positiv
mesh	Positiv
piety	Relig
gleam	Positiv
invaluable	Econ@
success	Positiv
affirm	Positiv
fresh	Positiv
attainment	Positiv
resurrect	Positiv
memorable	Positiv
bountiful	Positiv
statuesque	Positiv
give	Positiv
fragrant	Positiv
richness	Econ@
shelter	Positiv
offer	Positiv
myriad	Positiv
reassure	Positiv
sleek	Positiv
approach	Positiv
communicative	Positiv
dignified	Positiv
fashionable	Positiv
swiftness	Positiv
profit	Econ@
appoint	Positiv
tenacity	Positiv
ingenuity	Positiv
befit	Positiv
triumph	Positiv
privacy	Positiv
reunite	Positiv
reconcile	Positiv
augment	Positiv
thrive	Positiv
sworn	Legal
capability	Positiv
intricate	Positiv
ceaseless	Positiv
inquisitive	Positiv
order	Negativ
create	Exprsv
fascination	Positiv
amply	Positiv
impetus	Positiv
principal	Positiv
lively	Positiv
mate	Positiv
prodigy	Positiv
godlike	Positiv
adherent	Positiv
preeminent	Positiv
triumphal	Positiv
concur	Positiv
congratulate	Positiv
advocacy	Positiv
civil	Milit
definitive	Positiv
industrious	Positiv
pardon	Positiv
reinforcement	Positiv
dominance	Positiv
decipher	Positiv
harmonize	Positiv
back	Positiv
champion	Positiv
survivor	Positiv
absorption	Positiv
bargain	Econ@
goodbye	Positiv
heroine	Positiv
settle	Positiv
brainy	Positiv
laughter	Exprsv
aware	Positiv
brightness	Positiv
rapt	Positiv
accommodate	Positiv
acknowledgement	Positiv
attain	Positiv
company	Econ@
imagination	Exprsv
mediate	Positiv
liberalism	Polit@
crusade	Polit@
fullness	Positiv
bloom	Positiv
logic	Positiv
entertainment	Exprsv
intrigue	Positiv
reinstate	Legal
frolic	Positiv
entertain	Exprsv
inference	Positiv
brilliant	Positiv
moderation	Positiv
witty	Positiv
dance	Exprsv
outrun	Positiv
beauteous	Positiv
pledge	Polit@
precaution	Positiv
indomitable	Positiv
matchless	Positiv
remodel	Positiv
inaugurate	Positiv
energize	Positiv
upright	Positiv
backing	Positiv
restore	Positiv
straightforward	Positiv
imperative	Positiv
commune	Positiv
tenacious	Positiv
hygiene	Positiv
stood	Positiv
temperate	Positiv
credentials	Positiv
plenty	Positiv
admit	Positiv
aggregation	Positiv
sweeten	Positiv
arbitrate	Positiv
advisable	Positiv
appease	Positiv
groom	Positiv
acquaint	Positiv
speedily	Positiv
cohort	Positiv
nurse	Econ@
attract	Positiv
intercourse	Positiv
fitness	Positiv
steady	Positiv
bonus	Econ@
sagacity	Positiv
justice	Legal
gain	Econ@
competency	Positiv
familiarity	Positiv
revive	Positiv
exquisite	Positiv
amnesty	Legal
continuity	Positiv
facilitate	Positiv
companion	Positiv
aristocratic	Econ@
renewal	Positiv
candid	Positiv
consent	Positiv
reverent	Positiv
crusader	Polit@
justify	Positiv
poise	Positiv
hug	Positiv
economize	Econ@
lavish	Positiv
relevant	Positiv
outset	Positiv
restoration	Positiv
commission	Positiv
auspicious	Positiv
dauntless	Positiv
fertile	Positiv
affiliation	Positiv
colossal	Positiv
luster	Positiv
complementary	Positiv
maturity	Positiv
mindful	Positiv
invitation	Positiv
clout	Positiv
glorify	Positiv
unforgettable	Positiv
applause	Positiv
contribution	Positiv
renovate	Positiv
outgoing	Positiv
brilliance	Positiv
offset	Positiv
ensure	Positiv
cultivation	Positiv
dare	Positiv
festive	Positiv
commemorate	Positiv
major	Academ
affluence	Econ@
collaborate	Positiv
dazzle	Positiv
idolize	Positiv
potent	Positiv
quench	Positiv
sanity	Positiv
familiar	Positiv
ripe	Positiv
reap	Positiv
savvy	Positiv
augmentation	Positiv
desirous	Positiv
associate	Econ@
applaud	Positiv
boost	Positiv
rave	Positiv
aggregate	Positiv
revitalize	Positiv
classic	Academ
salutation	Positiv
traditional	Positiv
authority	Legal
moralistic	Positiv
vouchsafe	Positiv
award	Positiv
smile	Positiv
clearness	Positiv
devout	Positiv
proprietary	Positiv
rouse	Positiv
astound	Positiv
outlive	Positiv
conquest	Positiv
sturdy	Positiv
adherence	Positiv
festivity	Positiv
dawn	Positiv
glossy	Positiv
complement	Positiv
wondrous	Positiv
hope	Positiv
commend	Positiv
salute	Legal
riches	Econ@
stud	Positiv
admittance	Positiv
measurable	Positiv
permission	Positiv
fulfillment	Positiv
agreeable	Positiv
subsidize	Econ@
closeness	Positiv
partner	Econ@
rapport	Positiv
patronage	Econ@
even	Negativ
defend	Positiv
mutual	Positiv
generate	Positiv
revival	Positiv
cognizant	Positiv
attune	Positiv
assuredly	Positiv
beautify	Positiv
awareness	Positiv
conclusive	Positiv
embrace	Positiv
deal	Econ@
rightful	Legal
arbitration	Positiv
edible	Positiv
discern	Positiv
worthiness	Positiv
consideration	Positiv
conserve	Positiv
sanctify	Positiv
impunity	Legal
coincident	Positiv
credible	Positiv
affix	Positiv
autonomous	Legal
enhance	Positiv
topmost	Positiv
luxuriant	Positiv
elaborate	Positiv
uncommon	Positiv
shield	Positiv
alleviate	Positiv
frugal	Econ@
law	Legal
advent	Positiv
vagabond	Econ@
entreat	Negativ
bait	Negativ
straggler	Negativ
disavow	Negativ
languish	Negativ
rogue	Negativ
unnatural	Negativ
iron	Polit@
ostracize	Negativ
unaccustomed	Negativ
susceptible	Negativ
careen	Negativ
expedient	Negativ
show	Exprsv
shyness	Negativ
fragile	Negativ
secession	Polit@
slanderous	Negativ
dissatisfy	Negativ
veto	Negativ
abrupt	Negativ
provocation	Negativ
rivalry	Negativ
shortsighted	Negativ
swore	Negativ
hunt	Negativ
vengeance	Negativ
ferocity	Negativ
coerce	Negativ
desert	Negativ
crawl	Negativ
procrastination	Negativ
stab	Negativ
break	Legal
incredible	Negativ
volatile	Negativ
brandish	Negativ
rumple	Negativ
scandalous	Negativ
floor	Negativ
daze	Negativ
lag	Negativ
rid	Negativ
bandit	Negativ
combatant	Negativ
immobility	Negativ
aimless	Negativ
sedentary	Negativ
jar	Negativ
intimidate	Negativ
jeopardize	Negativ
whine	Negativ
resent	Negativ
bolt	Negativ
disproportionate	Negativ
interrupt	Negativ
abate	Negativ
disapprove	Negativ
close	Negativ
engulf	Negativ
erosion	Negativ
amputate	Negativ
anomaly	Negativ
robber	Legal
dependent	Negativ
liable	Negativ
rebellion	Milit
obscure	Negativ
harassment	Negativ
encroach	Negativ
recession	Econ@
robbery	Legal
alibi	Negativ
disagreement	Negativ
competition	Negativ
demise	Negativ
compulsion	Negativ
pretend	Negativ
leak	Negativ
recoil	Negativ
miser	Econ@
wickedness	Negativ
bloody	Negativ
expose	Negativ
oppose	Negativ
terrorize	Negativ
sucker	Negativ
anomalous	Negativ
dictate	Polit@
bewilderment	Negativ
condemn	Negativ
addiction	Negativ
hinder	Negativ
complain	Negativ
refrain	Negativ
grab	Negativ
resignation	Negativ
treasonous	Polit@
coarse	Negativ
annihilate	Negativ
boot	Negativ
bland	Negativ
knock	Negativ
taboo	Negativ
viper	Negativ
decrease	Negativ
unavoidable	Negativ
stringent	Negativ
defensive	Negativ
owe	Econ@
sank	Negativ
mistaken	Negativ
discrepant	Negativ
hungry	Negativ
discharge	Milit
fatalistic	Negativ
insensible	Negativ
nag	Negativ
transgress	Negativ
erase	Negativ
persecute	Negativ
muddy	Negativ
shrug	Negativ
lay	Econ@
chore	Negativ
lie	Negativ
criticize	Negativ
confront	Negativ
exclusion	Negativ
motley	Negativ
immature	Negativ
untruth	Negativ
intoxicate	Negativ
traitor	Negativ
demolish	Negativ
dawdle	Negativ
fool	Negativ
raid	Negativ
gamble	Econ@
procrastinate	Negativ
subjugate	Negativ
agitate	Negativ
naughty	Negativ
wait	Negativ
evade	Negativ
ambiguous	Negativ
complex	Negativ
faint	Negativ
hag	Negativ
wreck	Negativ
skirmish	Negativ
scream	Negativ
bug	Negativ
prosecution	Legal
slap	Negativ
worsen	Negativ
implicate	Negativ
bombardment	Negativ
coward	Negativ
bloodthirsty	Negativ
tariff	Econ@
complexity	Negativ
dominate	Negativ
succumb	Negativ
unseen	Negativ
object	Negativ
forfeit	Negativ
standstill	Negativ
flimsy	Negativ
constraint	Negativ
farce	Negativ
get	Negativ
dispel	Negativ
starvation	Negativ
snore	Negativ
subvert	Negativ
thorny	Negativ
bail	Negativ
altercation	Negativ
jail	Legal
tardy	Negativ
droop	Negativ
blatant	Negativ
devilish	Negativ
immovable	Negativ
skulk	Negativ
shun	Negativ
explosion	Negativ
jumpy	Negativ
irregularity	Negativ
darn	Negativ
deviation	Negativ
kick	Negativ
quitter	Negativ
unsafe	Negativ
conceal	Negativ
mock	Negativ
stain	Negativ
inflict	Negativ
erroneous	Negativ
inconvenient	Negativ
fighter	Negativ
shallow	Negativ
vexation	Negativ
merciless	Negativ
raise	Econ@
disarm	Negativ
rebuke	Negativ
suppression	Negativ
mistrust	Negativ
drive	Negativ
lawless	Legal
subside	Negativ
thud	Negativ
thwart	Negativ
gaudy	Negativ
negate	Negativ
wearisome	Negativ
rebel	Negativ
enslave	Polit@
meek	Negativ
precipitate	Negativ
drought	Negativ
obstruction	Negativ
blunder	Negativ
nightmare	Negativ
boisterous	Negativ
fretful	Negativ
impasse	Negativ
disposal	Negativ
forsake	Negativ
retreat	Milit
scrutinize	Negativ
slaughter	Negativ
molest	Negativ
distract	Negativ
bereave	Negativ
massacre	Negativ
heinous	Negativ
bewilder	Negativ
opponent	Negativ
trap	Negativ
vagrant	Econ@
struggle	Negativ
unsteadiness	Negativ
balk	Negativ
costliness	Econ@
retard	Negativ
foible	Negativ
cool	Negativ
hustler	Econ@
ambush	Milit
dark	Negativ
snare	Negativ
vexing	Negativ
obstruct	Negativ
smother	Negativ
fire	Econ@
argue	Negativ
accost	Negativ
insufficiency	Negativ
dull	Negativ
captive	Negativ
spank	Negativ
vex	Negativ
revert	Negativ
outburst	Negativ
race	Negativ
prohibition	Legal
strangle	Negativ
freak	Negativ
loner	Negativ
accuse	Legal
stormy	Negativ
stagnant	Negativ
criminal	Legal
abscond	Negativ
fallout	Negativ
collision	Negativ
inhibit	Negativ
blurt	Negativ
displace	Negativ
underworld	Econ@
exterminate	Negativ
discredit	Negativ
crude	Negativ
pretense	Negativ
darken	Negativ
spear	Milit
haggard	Negativ
repeal	Legal
smear	Negativ
crumple	Negativ
encroachment	Negativ
division	Negativ
disavowal	Negativ
inaccuracy	Negativ
intrude	Negativ
lifeless	Negativ
fall	Negativ
tramp	Negativ
fraud	Negativ
outbreak	Negativ
infection	Negativ
growl	Negativ
din	Negativ
worrier	Negativ
bury	Negativ
sunder	Negativ
combat	Polit@
wilt	Negativ
orphan	Negativ
admonish	Negativ
sneak	Negativ
incompetent	Negativ
shrivel	Negativ
inferiority	Negativ
frantically	Negativ
complicate	Negativ
undid	Negativ
wane	Negativ
theft	Legal
partition	Negativ
shirk	Negativ
exaggeration	Negativ
alarm	Negativ
dirt	Negativ
shipwreck	Negativ
rough	Negativ
sabotage	Negativ
deviate	Negativ
contradictory	Negativ
unguarded	Negativ
exception	Negativ
scar	Negativ
undone	Negativ
backward	Negativ
warp	Negativ
pick	Negativ
dent	Negativ
buckle	Negativ
hedge	Negativ
opposition	Negativ
sloppy	Negativ
withhold	Negativ
diabolical	Negativ
bungle	Negativ
nullify	Negativ
exploit	Negativ
pathetic	Negativ
nuts	Negativ
stray	Negativ
disable	Negativ
leakage	Negativ
tantrum	Negativ
renunciation	Negativ
explode	Negativ
low	Negativ
deterrent	Negativ
need	Negativ
weariness	Negativ
stamp	Econ@
jeopardy	Negativ
uninformed	Negativ
disrupt	Negativ
counteract	Negativ
abyss	Negativ
outlaw	Legal
expense	Econ@
isolate	Negativ
dump	Negativ
ration	Negativ
recede	Negativ
oddity	Negativ
entanglement	Polit@
ghetto	Negativ
collusion	Negativ
charge	Econ@
ineffectiveness	Negativ
retaliate	Negativ
misrepresent	Negativ
venomous	Negativ
muddle	Negativ
barren	Negativ
fat	Negativ
endanger	Negativ
slash	Negativ
secede	Polit@
loom	Negativ
sentence	Legal
detain	Negativ
imprisonment	Legal
expel	Negativ
feudal	Polit@
distortion	Negativ
counteraction	Negativ
clog	Negativ
pointless	Negativ
malady	Negativ
disingenuous	Negativ
screech	Negativ
implore	Negativ
brittle	Negativ
omit	Negativ
damn	Negativ
nosey	Negativ
lull	Negativ
mislead	Negativ
chastise	Negativ
quarrel	Negativ
deadlock	Negativ
inequality	Negativ
shoddy	Negativ
feint	Negativ
drowsy	Negativ
ruthless	Negativ
denial	Negativ
protest	Negativ
feud	Negativ
heedless	Negativ
abolish	Negativ
mutter	Negativ
obsolete	Negativ
ridicule	Negativ
avoid	Negativ
behead	Negativ
dictatorial	Polit@
marginal	Negativ
untrained	Negativ
invade	Polit@
indulge	Negativ
pessimism	Negativ
shrew	Negativ
temporarily	Negativ
capsize	Negativ
casualty	Negativ
bereft	Negativ
warlike	Polit@
haphazard	Negativ
conspiracy	Polit@
assassinate	Negativ
indeterminate	Negativ
retire	Negativ
blast	Negativ
root	Negativ
compel	Negativ
feign	Negativ
quit	Negativ
exit	Negativ
punish	Negativ
misinformed	Negativ
offend	Negativ
uproar	Negativ
derogatory	Negativ
imprison	Legal
asunder	Negativ
evict	Legal
mischievous	Negativ
epithet	Negativ
seize	Negativ
contagious	Negativ
rattle	Negativ
renounce	Negativ
hunger	Negativ
overbearing	Negativ
detract	Negativ
curt	Negativ
chide	Negativ
killer	Negativ
straggle	Negativ
cheapen	Negativ
taint	Negativ
cave	Negativ
fled	Negativ
suspend	Negativ
default	Econ@
withheld	Negativ
fake	Negativ
against	Negativ
fumble	Negativ
deter	Negativ
torrent	Negativ
banishment	Polit@
throw	Negativ
misunderstanding	Negativ
corrosive	Negativ
bum	Econ@
colony	Polit@
debtor	Econ@
revenge	Negativ
wee	Negativ
lower	Negativ
fugitive	Legal
eliminate	Negativ
liar	Negativ
grumble	Negativ
murky	Negativ
sinful	Negativ
starve	Negativ
coercive	Negativ
confess	Negativ
gullible	Negativ
distort	Negativ
decease	Negativ
wanton	Negativ
demean	Negativ
shortage	Negativ
snarl	Negativ
baffle	Negativ
offender	Negativ
fleeting	Negativ
intruder	Negativ
perplexity	Negativ
superfluous	Negativ
perish	Negativ
convict	Legal
quarrelsome	Negativ
gruff	Negativ
ruffian	Negativ
provoke	Negativ
mine	Econ@
disclaim	Negativ
delay	Negativ
constrain	Negativ
revolution	Polit@
tempest	Negativ
annoy	Negativ
devious	Negativ
menial	Negativ
paralyzed	Negativ
drag	Negativ
subversion	Negativ
mishap	Negativ
shake	Negativ
accident	Negativ
passe	Negativ
overworked	Negativ
doomsday	Negativ
nix	Negativ
toil	Negativ
lame	Negativ
capture	Negativ
diversion	Negativ
adversary	Polit@
hackney	Negativ
vague	Negativ
deplore	Negativ
insinuate	Negativ
smuggle	Negativ
glare	Negativ
rubbish	Negativ
esoteric	Negativ
reproach	Negativ
wayward	Negativ
autocrat	Polit@
admonition	Negativ
blur	Negativ
goddamn	Negativ
antiquated	Negativ
terrorism	Negativ
dying	Negativ
depreciation	Econ@
blah	Negativ
insult	Negativ
ineffective	Negativ
submissive	Negativ
rebuff	Negativ
slayer	Negativ
congestion	Negativ
deplete	Negativ
frivolous	Negativ
oblique	Negativ
scandal	Negativ
spoil	Negativ
mediocre	Negativ
unarm	Negativ
revolt	Polit@
entangle	Polit@
nullification	Negativ
pitiful	Negativ
nebulous	Negativ
founder	Negativ
sneer	Negativ
slanderer	Negativ
thief	Legal
oust	Negativ
agitator	Negativ
harass	Negativ
elimination	Negativ
stern	Negativ
conspire	Negativ
crush	Negativ
sag	Negativ
contrary	Negativ
infest	Negativ
regardless	Negativ
unnoticed	Negativ
censure	Negativ
inefficiency	Negativ
turbulent	Negativ
indeterminable	Negativ
illogical	Negativ
villain	Negativ
rumor	Negativ
abandon	Negativ
displease	Negativ
let	Negativ
execute	Negativ
rival	Negativ
haziness	Negativ
eccentric	Negativ
unruly	Negativ
taunt	Negativ
scarcity	Negativ
extinct	Negativ
kidnap	Legal
cataclysm	Negativ
stole	Legal
wily	Negativ
repulse	Negativ
monster	Negativ
fuss	Negativ
revoke	Negativ
unlawful	Legal
calamity	Negativ
misbehave	Negativ
uneven	Negativ
block	Negativ
fraudulent	Negativ
hang	Negativ
falter	Negativ
flaw	Negativ
insolence	Negativ
violate	Negativ
ride	Negativ
belie	Negativ
sequester	Legal
rusty	Negativ
problem	Negativ
antagonist	Negativ
infraction	Legal
bout	Negativ
unforeseen	Negativ
inundated	Negativ
gloat	Negativ
sarcastic	Negativ
bombard	Negativ
tear	Negativ
curtail	Negativ
sleepless	Negativ
usurp	Polit@
quibble	Negativ
substitution	Negativ
crushing	Negativ
embarrass	Negativ
crumble	Negativ
exclude	Negativ
wicked	Negativ
manipulation	Negativ
pompous	Negativ
forbidden	Negativ
brazen	Negativ
bafflement	Negativ
insolent	Negativ
bar	Exprsv
bravado	Negativ
shark	Negativ
manipulate	Negativ
lazily	Negativ
disprove	Negativ
excess	Negativ
suffocate	Negativ
vagueness	Negativ
vie	Negativ
hell	Relig
shell	Milit
gratuitous	Negativ
prisoner	Legal
infect	Negativ
sleazy	Negativ
stubbornly	Negativ
pound	Negativ
bullet	Negativ
devastate	Negativ
scoff	Negativ
split	Negativ
fret	Negativ
abandonment	Negativ
liability	Negativ
cost	Econ@
alien	Negativ
evasion	Negativ
box	Exprsv
paltry	Negativ
liquidate	Econ@
confine	Negativ
daunting	Negativ
wild	Negativ
stubbornness	Negativ
betray	Negativ
reactionary	Polit@
banish	Polit@
scowl	Negativ
discordant	Negativ
uncivil	Negativ
impair	Negativ
knife	Negativ
contradict	Negativ
fiend	Negativ
neutralize	Negativ
poisonous	Negativ
humiliate	Negativ
eradicate	Negativ
inflame	Negativ
overthrow	Negativ
horrify	Negativ
stifle	Negativ
ineffectual	Negativ
wrath	Negativ
mischief	Negativ
runaway	Negativ
denounce	Negativ
dim	Negativ
shroud	Negativ
defile	Negativ
compete	Negativ
rebut	Negativ
err	Negativ
hunter	Exprsv
tax	Econ@
commonplace	Negativ
deluge	Negativ
pry	Negativ
critic	Exprsv
assail	Negativ
savage	Negativ
trudge	Negativ
lurk	Negativ
anarchy	Polit@
rebellious	Polit@
demoralize	Negativ
slam	Negativ
dispute	Negativ
perplex	Negativ
startle	Negativ
clique	Negativ
controversial	Negativ
whack	Negativ
impose	Negativ
lowly	Negativ
frown	Negativ
autocratic	Polit@
slight	Negativ
shot	Negativ
exile	Negativ
patronize	Negativ
malignant	Negativ
vanish	Negativ
senile	Negativ
suspension	Negativ
oppress	Negativ
persecution	Negativ
abdicate	Negativ
suspect	Legal
deny	Negativ
hater	Negativ
warfare	Milit
tease	Negativ
cancellation	Negativ
regress	Negativ
secrecy	Negativ
barrier	Negativ
noise	Negativ
siege	Polit@
push	Negativ
sever	Negativ
oppression	Negativ
paralysis	Negativ
utterance	Negativ
cannon	Milit
flounder	Negativ
exhaust	Negativ
lying	Negativ
lure	Negativ
misunderstand	Negativ
refugee	Polit@
belt	Negativ
volatility	Negativ
disregard	Negativ
undo	Negativ
devoid	Negativ
dishonest	Negativ
eccentricity	Negativ
dead	Negativ
debatable	Negativ
ruthlessness	Negativ
trivial	Negativ
miss	Negativ
plod	Negativ
flee	Negativ
forbid	Negativ
scapegoat	Negativ
defendant	Negativ
curse	Negativ
grapple	Negativ
diabolic	Negativ
outsider	Negativ
reject	Negativ
atrophy	Negativ
struck	Negativ
unreasonable	Negativ
cancel	Negativ
alas	Negativ
trespass	Negativ
refusal	Negativ
repudiate	Negativ
smack	Negativ
bastard	Negativ
overlook	Negativ
fiasco	Negativ
complaint	Negativ
mishandle	Negativ
wrestle	Negativ
limp	Negativ
incessant	Negativ
secret	Negativ
censor	Negativ
thrash	Negativ
beggar	Econ@
brawl	Negativ
spill	Negativ
hoard	Negativ
credulous	Negativ
prison	Legal
interfere	Negativ
restriction	Legal
overwhelming	Negativ
impede	Negativ
darkness	Negativ
inflation	Econ@
devil	Relig
spinster	Negativ
fatal	Negativ
injunction	Legal
defame	Negativ
besiege	Negativ
point	Negativ
propaganda	Polit@
overrun	Negativ
disbelief	Negativ
kill	Negativ
afflict	Negativ
competitor	Negativ
guise	Negativ
poison	Negativ
scorch	Negativ
peril	Negativ
novice	Negativ
decline	Negativ
commoner	Econ@
cumbersome	Negativ
capitulate	Negativ
jeer	Negativ
pandemonium	Negativ
plot	Negativ
mangle	Negativ
deceptive	Negativ
incompetence	Negativ
inexplicable	Negativ
meddle	Negativ
contradiction	Negativ
interruption	Negativ
falsehood	Negativ
aggressor	Negativ
melodramatic	Exprsv
turn	Negativ
battlefield	Negativ
intrusion	Negativ
slander	Negativ
parasite	Negativ
epidemic	Negativ
pollute	Legal
enforce	Legal
collapse	Negativ
twitch	Negativ
ambiguity	Negativ
cram	Negativ
culpable	Negativ
inundate	Negativ
murderous	Negativ
haunt	Negativ
allegation	Legal
relapse	Negativ
laid	Econ@
flagrant	Negativ
outcast	Negativ
distracting	Negativ
lose	Negativ
dismiss	Negativ
disguise	Negativ
witchcraft	Negativ
snatch	Negativ
swear	Negativ
assassin	Negativ
shabby	Negativ
anarchist	Polit@
run	Econ@
rot	Negativ
differ	Negativ
degrade	Negativ
beware	Negativ
gunmen	Negativ
ravage	Negativ
shove	Negativ
tatter	Negativ
breach	Negativ
excommunication	Legal
confiscate	Negativ
needy	Negativ
junk	Negativ
war	Milit
fist	Negativ
subtract	Negativ
topple	Negativ
segregation	Negativ
motionless	Negativ
torment	Negativ
uprising	Negativ
divide	Negativ
uproot	Negativ
contaminate	Negativ
battle	Milit
ax	Legal
storm	Negativ
empty	Negativ
enemy	Negativ
scold	Negativ
seethe	Negativ
frigid	Negativ
helpless	Negativ
yawn	Negativ
betrayal	Negativ
meager	Negativ
rip	Negativ
ramble	Negativ
alienate	Negativ
avert	Negativ
unprofitable	Econ@
babble	Negativ
sputter	Negativ
dumb	Negativ
conspirator	Negativ
discriminate	Negativ
allege	Negativ
shadow	Negativ
beseech	Negativ
wench	Negativ
brag	Negativ
feverish	Negativ
hazy	Negativ
rigor	Negativ
fraught	Negativ
sufferer	Negativ
nonchalant	Negativ
croak	Negativ
breakdown	Negativ
loser	Negativ
famished	Negativ
sap	Negativ
neglect	Negativ
astray	Negativ
corrode	Negativ
subjugation	Negativ
brusque	Negativ
bomb	Milit
subservience	Negativ
mockery	Negativ
aggravate	Negativ
extermination	Negativ
stammer	Negativ
weaken	Negativ
censorship	Negativ
absent	Negativ
drowsiness	Negativ
hamper	Negativ
pessimistic	Negativ
treason	Polit@
unhealthy	Negativ
explosive	Negativ
unobserved	Negativ
gun	Milit
nasty	Negativ
blackmail	Econ@
upheaval	Negativ
hobble	Negativ
exempt	Negativ
argument	Negativ
invisible	Negativ
irregular	Negativ
scuffle	Negativ
fought	Negativ
dispense	Negativ
blow	Negativ
pitiless	Negativ
prod	Negativ
foreboding	Negativ
foe	Negativ
obliterate	Negativ
deprive	Negativ
depose	Negativ
squander	Econ@
exasperate	Negativ
extinguish	Negativ
scheme	Negativ
contend	Negativ
jerk	Negativ
depreciate	Negativ
overturn	Legal
slump	Negativ
club	Milit
overflow	Negativ
guerrilla	Milit
thirst	Negativ
horde	Negativ
subjection	Negativ
beg	Negativ
confession	Negativ
chase	Negativ
deride	Negativ
misunderstood	Negativ
defy	Negativ
dungeon	Negativ
treachery	Negativ
absence	Negativ
belated	Negativ
prohibit	Legal
powerless	Negativ
addict	Negativ
avoidance	Negativ
punch	Negativ
stupor	Negativ
sarcasm	Negativ
fallacy	Negativ
ultimatum	Negativ
misinform	Negativ
servitude	Negativ
weed	Negativ
infuriate	Negativ
unsteady	Negativ
indictment	Legal
threaten	Negativ
stalemate	Negativ
thirsty	Negativ
decompose	Negativ
truant	Legal
drop	Negativ
suppress	Negativ
destroy	Negativ
aggrieve	Negativ
corrosion	Negativ
piece	Econ@
dwindle	Negativ
plaintiff	Legal
needle	Negativ
hollow	Negativ
overpower	Negativ
choke	Negativ
untimely	Negativ
illiterate	Negativ
trample	Negativ
shred	Negativ
mumble	Negativ
obstacle	Negativ
decay	Negativ
undermine	Negativ
assailant	Negativ
slime	Negativ
congested	Negativ
drown	Negativ
lapse	Negativ
screw	Negativ
unequal	Negativ
fabricate	Negativ
accusation	Negativ
stark	Negativ
prowl	Negativ
bit	Negativ
tamper	Negativ
senseless	Negativ
adulterate	Negativ
incurable	Negativ
inconsistency	Negativ
belittle	Negativ
fidget	Negativ
divert	Negativ
blunt	Negativ
collide	Negativ
germ	Negativ
vomit	Negativ
hustle	Econ@
omission	Negativ
erode	Negativ
clash	Negativ
death	Negativ
austere	Negativ
imperialist	Polit@
convention	Polit@
conservatism	Polit@
federation	Polit@
platform	Polit@
palace	Polit@
partisan	Polit@
crown	Polit@
conference	Polit@
congress	Polit@
ideology	Polit@
ministry	Polit@
amendment	Legal
confederate	Polit@
commissioner	Polit@
labor	Econ@
vote	Polit@
revolutionary	Polit@
primary	Polit@
victory	Polit@
government	Polit@
kingdom	Polit@
utopian	Polit@
spokesman	Polit@
capitol	Polit@
junta	Legal
municipality	Polit@
voter	Polit@
ruler	Polit@
white	Econ@
armistice	Milit
settlement	Polit@
chancellor	Polit@
villager	Polit@
tribe	Polit@
candidate	Polit@
metropolitan	Polit@
socialism	Polit@
table	Polit@
secretary	Econ@
empire	Polit@
socialist	Polit@
surrender	Milit
corps	Milit
national	Polit@
president	Polit@
royalty	Polit@
society	Polit@
emperor	Polit@
statesman	Polit@
reds	Polit@
minutemen	Milit
constitutional	Polit@
tactic	Polit@
cabinet	Polit@
interstate	Polit@
embassy	Polit@
presidency	Polit@
representative	Polit@
ballot	Polit@
communist	Econ@
elite	Polit@
diplomatic	Polit@
campaigner	Polit@
nation	Polit@
body	Polit@
delegation	Polit@
establishment	Econ@
province	Polit@
tribal	Polit@
communism	Econ@
sovereign	Polit@
regime	Polit@
politics	Polit@
legion	Milit
dictator	Polit@
governor	Polit@
royal	Polit@
conservative	Polit@
exchange	Econ@
precinct	Polit@
republican	Polit@
election	Polit@
tory	Polit@
elect	Polit@
poll	Polit@
jurisdiction	Legal
prince	Polit@
ship	Polit@
administration	Polit@
social	Econ@
capitalism	Econ@
liberation	Polit@
colonial	Polit@
federal	Polit@
frontier	Polit@
debate	Polit@
metropolis	Polit@
municipal	Polit@
democrat	Polit@
draft	Milit
international	Polit@
rule	Legal
country	Polit@
union	Econ@
senate	Polit@
sovereignty	Polit@
legislator	Legal
king	Polit@
demonstration	Polit@
congressional	Polit@
presidential	Polit@
constitution	Polit@
ambassador	Polit@
imperial	Polit@
court	Legal
left	Polit@
house	Polit@
governmental	Polit@
campaign	Polit@
parliament	Polit@
border	Polit@
legislative	Legal
republic	Polit@
govern	Polit@
legislation	Legal
dictatorship	Polit@
political	Polit@
bill	Econ@
census	Polit@
petition	Polit@
congressmen	Polit@
citizen	Polit@
league	Polit@
party	Exprsv
utopia	Polit@
delegate	Polit@
lord	Polit@
minority	Polit@
politician	Polit@
queen	Polit@
county	Polit@
statesmen	Polit@
congressman	Polit@
mayor	Polit@
coalition	Polit@
commonwealth	Polit@
diplomacy	Polit@
nomination	Polit@
state	Polit@
democratic	Polit@
senator	Polit@
flag	Polit@
religion	Relig
seeker	Relig
god	Relig
christianity	Relig
believer	Relig
soul	Relig
cathedral	Relig
hymn	Relig
orthodox	Relig
church	Relig
crucifix	Relig
cult	Relig
zen	Relig
catholic	Relig
gospel	Relig
pastor	Relig
rector	Relig
witch	Relig
missionary	Relig
reverend	Relig
ghost	Relig
theological	Relig
myth	Relig
priest	Relig
congregational	Relig
theology	Relig
pope	Relig
testament	Legal
chapel	Relig
goddess	Relig
denominational	Relig
bishop	Relig
christian	Relig
sermon	Relig
biblical	Relig
magic	Relig
prayer	Relig
christmas	Relig
fate	Relig
stoicism	Relig
easter	Relig
metaphysics	Relig
ecumenical	Relig
clergyman	Relig
pilgrimage	Relig
preacher	Relig
congregation	Relig
convert	Relig
worship	Relig
christ	Relig
eternal	Relig
seminary	Academ
pray	Relig
parish	Relig
preach	Relig
bible	Relig
metaphysical	Relig
constable	Legal
agent	Legal
warrant	Legal
statutory	Legal
jury	Legal
stipulate	Legal
official	Legal
detective	Legal
lawyer	Legal
deposition	Legal
attorney	Legal
evidence	Legal
entitle	Legal
sanction	Legal
verdict	Legal
owner	Legal
authorize	Legal
officiate	Legal
registration	Legal
trial	Legal
stipulation	Legal
policeman	Legal
issue	Legal
contract	Econ@
litigant	Legal
probation	Legal
oath	Legal
testimony	Legal
judgment	Legal
private	Milit
summon	Legal
advocate	Legal
certify	Legal
enforcement	Legal
auditor	Econ@
cop	Legal
solicitor	Legal
ordinance	Legal
witness	Legal
judge	Legal
posse	Legal
statute	Legal
juror	Legal
hear	Legal
judicial	Legal
patent	Legal
certificate	Legal
license	Legal
marshall	Legal
testify	Legal
apply	Legal
case	Legal
proceed	Econ@
title	Legal
sheriff	Legal
police	Legal
certification	Legal
litigation	Legal
proprietor	Econ@
policemen	Legal
warrior	Milit
army	Milit
munition	Milit
soldier	Milit
fleet	Milit
parade	Milit
fort	Milit
veteran	Milit
militia	Milit
weapon	Milit
submarine	Milit
pentagon	Milit
commander	Milit
missile	Milit
naval	Milit
rifle	Milit
stronghold	Milit
ammunition	Milit
march	Milit
castle	Milit
armed	Milit
corporal	Milit
patrol	Milit
military	Milit
sword	Milit
navy	Milit
recruit	Milit
pistol	Milit
guard	Milit
destroyer	Milit
regiment	Milit
troop	Milit
cavalry	Milit
trigger	Milit
colonel	Milit
tnt	Milit
marcher	Milit
sergeant	Milit
blockade	Milit
coup	Milit
general	Milit
arm	Milit
rocket	Milit
lieutenant	Milit
arrow	Milit
infantry	Milit
air	Milit
grenade	Milit
architecture	Exprsv
catcher	Exprsv
perform	Exprsv
bandstand	Exprsv
swimmer	Exprsv
poetry	Exprsv
swim	Exprsv
marksman	Exprsv
imagine	Exprsv
poet	Exprsv
stadium	Exprsv
guitar	Exprsv
orchestra	Exprsv
field	Exprsv
gymnast	Exprsv
imagery	Exprsv
painter	Exprsv
roll	Exprsv
violin	Exprsv
spectator	Exprsv
bat	Exprsv
conductor	Exprsv
runner	Exprsv
architect	Exprsv
science	Academ
streamer	Exprsv
stage	Exprsv
bard	Exprsv
symphony	Exprsv
picture	Exprsv
maker	Exprsv
image	Exprsv
quartet	Exprsv
gymnastic	Exprsv
derby	Exprsv
literature	Academ
walker	Exprsv
giant	Exprsv
speech	Exprsv
sing	Exprsv
essay	Academ
invent	Exprsv
opera	Exprsv
camp	Exprsv
player	Exprsv
pace	Exprsv
expression	Exprsv
musician	Exprsv
symbol	Exprsv
drama	Exprsv
concert	Exprsv
swam	Exprsv
symbolism	Exprsv
sail	Exprsv
theatre	Exprsv
draw	Exprsv
dancer	Exprsv
theater	Exprsv
artistic	Exprsv
piano	Exprsv
ski	Exprsv
poem	Exprsv
symphonic	Exprsv
hop	Exprsv
creator	Exprsv
baseball	Exprsv
star	Exprsv
author	Exprsv
express	Exprsv
write	Exprsv
assignment	Exprsv
fence	Exprsv
bowl	Exprsv
biography	Exprsv
play	Exprsv
paint	Exprsv
singer	Exprsv
sung	Exprsv
medal	Exprsv
match	Exprsv
sang	Exprsv
imaginary	Exprsv
prose	Exprsv
movie	Exprsv
row	Exprsv
wave	Exprsv
literary	Academ
jazz	Exprsv
sculpture	Exprsv
fiction	Exprsv
tennis	Exprsv
boxer	Exprsv
verbal	Exprsv
performer	Exprsv
pool	Exprsv
satire	Exprsv
actor	Exprsv
tune	Exprsv
racer	Exprsv
camera	Exprsv
song	Exprsv
music	Exprsv
figure	Exprsv
aesthetic	Exprsv
studio	Exprsv
keyboard	Exprsv
imaginable	Exprsv
orator	Exprsv
sketch	Exprsv
story	Exprsv
novel	Exprsv
traveler	Exprsv
tale	Exprsv
portrait	Exprsv
verse	Exprsv
written	Exprsv
gallery	Exprsv
artist	Exprsv
ornament	Exprsv
anecdote	Exprsv
fashion	Exprsv
football	Exprsv
bridge	Exprsv
record	Exprsv
dramatic	Exprsv
composer	Exprsv
joker	Exprsv
narrative	Exprsv
performance	Exprsv
vacation	Exprsv
whistle	Exprsv
novelist	Exprsv
saga	Exprsv
musical	Exprsv
drum	Exprsv
expressive	Exprsv
trumpet	Exprsv
tourist	Econ@
legend	Exprsv
hide	Exprsv
writer	Exprsv
rock	Exprsv
laborer	Econ@
commodity	Econ@
sold	Econ@
occupational	Econ@
hanger	Econ@
factory	Econ@
businessmen	Econ@
broker	Econ@
harbor	Econ@
agriculture	Econ@
wage	Econ@
craft	Econ@
cash	Econ@
invest	Econ@
purchase	Econ@
earn	Econ@
goods	Econ@
butcher	Econ@
plant	Econ@
currency	Econ@
agency	Econ@
journalist	Econ@
technical	Econ@
taxable	Econ@
possession	Econ@
agricultural	Econ@
lent	Econ@
manager	Econ@
bookkeeping	Econ@
estimate	Econ@
promotion	Econ@
bank	Econ@
livelihood	Econ@
mechanic	Econ@
cafe	Econ@
discount	Econ@
dentist	Econ@
expend	Econ@
planer	Econ@
yield	Econ@
trade	Econ@
rancher	Econ@
insure	Econ@
oil	Econ@
nickel	Econ@
miller	Econ@
undertaker	Econ@
managerial	Econ@
newspaperman	Econ@
sell	Econ@
designer	Econ@
tractor	Econ@
debt	Econ@
enterprise	Econ@
taxpayer	Econ@
collective	Econ@
technology	Econ@
salesman	Econ@
waiter	Econ@
ranch	Econ@
harvest	Econ@
motel	Econ@
post	Econ@
career	Econ@
syndicate	Econ@
revenue	Econ@
management	Econ@
newsmen	Econ@
salary	Econ@
slave	Econ@
charter	Econ@
vocational	Econ@
win	Econ@
cheat	Econ@
money	Econ@
monopoly	Econ@
department	Econ@
incorporate	Econ@
hire	Econ@
fish	Econ@
exchequer	Econ@
custom	Econ@
cent	Econ@
import	Econ@
metal	Econ@
manufacturer	Econ@
grant	Econ@
planner	Econ@
check	Econ@
commercial	Econ@
restaurant	Econ@
employee	Econ@
enrollment	Econ@
trader	Econ@
business	Econ@
economic	Econ@
salesmanship	Econ@
treasurer	Econ@
bought	Econ@
peasant	Econ@
teamster	Econ@
office	Econ@
carpenter	Econ@
property	Econ@
miner	Econ@
clerk	Econ@
loan	Econ@
publish	Econ@
barn	Econ@
consume	Econ@
consumer	Econ@
workshop	Econ@
controller	Econ@
ranger	Econ@
distributor	Econ@
boarder	Econ@
pension	Econ@
surgeon	Econ@
maid	Econ@
zinc	Econ@
engineer	Econ@
laboratory	Academ
industry	Econ@
market	Econ@
promote	Econ@
auction	Econ@
bet	Econ@
merchant	Econ@
rental	Econ@
monetary	Econ@
professional	Econ@
plantation	Econ@
flyer	Econ@
mill	Econ@
investment	Econ@
payroll	Econ@
user	Econ@
lab	Academ
plow	Econ@
merchandise	Econ@
baker	Econ@
consultant	Econ@
barber	Econ@
shop	Econ@
port	Econ@
bid	Econ@
economics	Academ
dollar	Econ@
employment	Econ@
insurance	Econ@
porter	Econ@
sweep	Econ@
operator	Econ@
ledger	Econ@
seller	Econ@
businessman	Econ@
wholesale	Econ@
uranium	Econ@
coachman	Econ@
pasture	Econ@
grower	Econ@
economy	Econ@
payer	Econ@
technician	Econ@
boss	Econ@
product	Econ@
overseer	Econ@
manufacture	Econ@
taxation	Econ@
sponsor	Econ@
ticket	Econ@
salesmen	Econ@
fare	Econ@
foundation	Econ@
livestock	Econ@
customer	Econ@
brand	Econ@
repaid	Econ@
coin	Econ@
pilot	Econ@
editor	Econ@
janitor	Econ@
toll	Econ@
payment	Econ@
guild	Econ@
finance	Econ@
valuation	Econ@
rent	Econ@
cheque	Econ@
banker	Econ@
utility	Econ@
store	Econ@
builder	Econ@
executive	Econ@
refund	Econ@
treasury	Econ@
repay	Econ@
firm	Econ@
employer	Econ@
tobacco	Econ@
mortgage	Econ@
freight	Econ@
retail	Econ@
investor	Econ@
client	Econ@
worker	Econ@
landlord	Econ@
borrow	Econ@
commerce	Econ@
hotel	Econ@
occupation	Econ@
mineral	Econ@
lend	Econ@
supplier	Econ@
subscriber	Econ@
produce	Econ@
shipment	Econ@
gardener	Econ@
farm	Econ@
room	Econ@
producer	Econ@
servant	Econ@
dealer	Econ@
corporation	Econ@
fee	Econ@
walk	Econ@
consumption	Econ@
roofer	Econ@
gross	Econ@
financial	Econ@
seaman	Econ@
slum	Econ@
industrial	Econ@
reporter	Econ@
technological	Econ@
ownership	Econ@
specialist	Econ@
price	Econ@
cannery	Econ@
aluminum	Econ@
expenditure	Econ@
slavery	Econ@
boatswain	Econ@
income	Econ@
belong	Econ@
afford	Econ@
farmer	Econ@
doctor	Econ@
plumber	Econ@
account	Econ@
corp	Econ@
earner	Econ@
sale	Econ@
employ	Econ@
fund	Econ@
planter	Econ@
inventory	Econ@
teller	Econ@
budget	Econ@
seamen	Econ@
tailor	Econ@
profession	Econ@
job	Econ@
cook	Econ@
copper	Econ@
fiscal	Econ@
personnel	Econ@
output	Econ@
semester	Academ
physics	Academ
philosophic	Academ
linguist	Academ
historic	Academ
psychologist	Academ
grammar	Academ
exam	Academ
literalness	Academ
english	Academ
experiment	Academ
history	Academ
biological	Academ
examination	Academ
coach	Academ
test	Academ
clinical	Academ
form	Academ
high	Academ
dean	Academ
student	Academ
discourse	Academ
freshmen	Academ
philosophical	Academ
scientist	Academ
graduate	Academ
geometry	Academ
educate	Academ
museum	Academ
freshman	Academ
sociological	Academ
teacher	Academ
chemistry	Academ
lecture	Academ
professor	Academ
historical	Academ
letter	Academ
lesson	Academ
scholastic	Academ
scholar	Academ
statistics	Academ
mathematics	Academ
senior	Academ
instruction	Academ
teach	Academ
typography	Academ
campus	Academ
mathematical	Academ
academic	Academ
school	Academ
classroom	Academ
experimental	Academ
course	Academ
historian	Academ
examine	Academ
examiner	Academ
thinker	Academ
research	Academ
instruct	Academ
theory	Academ
read	Academ
faculty	Academ
scholarship	Academ
schoolroom	Academ
dr	Academ
math	Academ
word	Academ
pta	Academ
pupil	Academ
psychiatrist	Academ
university	Academ
degree	Academ
institute	Academ
physicist	Academ
junior	Academ
nutrition	Academ
astronomy	Academ
grind	Academ
scientific	Academ
theoretical	Academ
physician	Academ
philosopher	Academ
statistical	Academ
instructor	Academ
library	Academ
proctor	Academ
counselor	Academ
undergraduate	Academ
psychological	Academ
grade	Academ
questionnaire	Academ
academy	Academ
taught	Academ
matriculate	Academ
college	Academ
text	Academ
sociology	Academ
platonism	Academ
